"Region";"Prøvetagningsdato";"Køn";"Bekræftede tilfælde i alt";"Døde";"Indlæggelser";"Kummuleret antal døde";"Kummuleret antal bekræftede tilfælde";"Kummuleret antal indlæggelser"
Sjælland;2020-02-26;M;1;0;0;0;1;0
Hovedstaden;2020-02-27;M;1;0;0;0;2;0
Midtjylland;2020-02-28;M;1;0;0;0;3;0
Hovedstaden;2020-03-01;M;1;0;1;0;4;1
Hovedstaden;2020-03-02;M;2;0;1;0;6;2
Sjælland;2020-03-02;M;1;0;0;0;7;2
Syddanmark;2020-03-02;M;1;0;0;0;8;2
Hovedstaden;2020-03-03;F;1;0;0;0;9;2
Hovedstaden;2020-03-03;M;3;0;1;0;12;3
Hovedstaden;2020-03-04;M;2;0;0;0;14;3
Sjælland;2020-03-04;M;1;0;1;0;15;4
Hovedstaden;2020-03-05;F;4;1;1;1;19;5
Hovedstaden;2020-03-05;M;6;1;2;2;25;7
Nordjylland;2020-03-06;M;1;0;0;2;26;7
Sjælland;2020-03-06;M;1;0;1;2;27;8
Hovedstaden;2020-03-07;F;5;0;1;2;32;9
Hovedstaden;2020-03-07;M;3;0;1;2;35;10
Midtjylland;2020-03-07;M;1;0;0;2;36;10
Hovedstaden;2020-03-08;F;8;0;0;2;44;10
Midtjylland;2020-03-08;F;6;0;0;2;50;10
Sjælland;2020-03-08;F;2;0;1;2;52;11
Syddanmark;2020-03-08;F;1;0;0;2;53;11
Hovedstaden;2020-03-08;M;4;0;1;2;57;12
Midtjylland;2020-03-08;M;16;0;0;2;73;12
Nordjylland;2020-03-08;M;1;0;0;2;74;12
Sjælland;2020-03-08;M;2;0;0;2;76;12
Syddanmark;2020-03-08;M;8;0;0;2;84;12
Hovedstaden;2020-03-09;F;27;0;3;2;111;15
Midtjylland;2020-03-09;F;10;0;1;2;121;16
Nordjylland;2020-03-09;F;2;0;0;2;123;16
Sjælland;2020-03-09;F;7;0;4;2;130;20
Syddanmark;2020-03-09;F;15;0;1;2;145;21
Hovedstaden;2020-03-09;M;44;0;4;2;189;25
Midtjylland;2020-03-09;M;35;0;2;2;224;27
Nordjylland;2020-03-09;M;6;0;0;2;230;27
Sjælland;2020-03-09;M;30;0;4;2;260;31
Syddanmark;2020-03-09;M;34;0;1;2;294;32
Hovedstaden;2020-03-10;F;46;0;4;2;340;36
Midtjylland;2020-03-10;F;18;0;1;2;358;37
Nordjylland;2020-03-10;F;4;0;1;2;362;38
Sjælland;2020-03-10;F;6;0;2;2;368;40
Syddanmark;2020-03-10;F;8;0;1;2;376;41
Hovedstaden;2020-03-10;M;70;1;3;3;446;44
Midtjylland;2020-03-10;M;54;1;4;4;500;48
Nordjylland;2020-03-10;M;9;0;0;4;509;48
Sjælland;2020-03-10;M;21;0;4;4;530;52
Syddanmark;2020-03-10;M;19;0;1;4;549;53
Hovedstaden;2020-03-11;F;31;0;2;4;580;55
Midtjylland;2020-03-11;F;11;1;1;5;591;56
Nordjylland;2020-03-11;F;3;0;0;5;594;56
Sjælland;2020-03-11;F;12;0;1;5;606;57
Syddanmark;2020-03-11;F;16;0;1;5;622;58
Hovedstaden;2020-03-11;M;57;0;3;5;679;61
Midtjylland;2020-03-11;M;14;1;1;6;693;62
Nordjylland;2020-03-11;M;20;0;0;6;713;62
Sjælland;2020-03-11;M;15;0;5;6;728;67
Syddanmark;2020-03-11;M;27;0;1;6;755;68
Hovedstaden;2020-03-12;F;9;1;3;7;764;71
Midtjylland;2020-03-12;F;2;0;2;7;766;73
Nordjylland;2020-03-12;F;1;0;1;7;767;74
Sjælland;2020-03-12;F;1;1;1;8;768;75
Syddanmark;2020-03-12;F;5;0;2;8;773;77
Hovedstaden;2020-03-12;M;9;0;3;8;782;80
Midtjylland;2020-03-12;M;6;0;4;8;788;84
Sjælland;2020-03-12;M;5;0;3;8;793;87
Syddanmark;2020-03-12;M;3;0;0;8;796;87
Hovedstaden;2020-03-13;F;5;0;1;8;801;88
Midtjylland;2020-03-13;F;2;0;1;8;803;89
Sjælland;2020-03-13;F;1;0;1;8;804;90
Syddanmark;2020-03-13;F;1;1;1;9;805;91
Hovedstaden;2020-03-13;M;16;2;8;11;821;99
Midtjylland;2020-03-13;M;5;1;5;12;826;104
Nordjylland;2020-03-13;M;1;0;1;12;827;105
Sjælland;2020-03-13;M;2;0;1;12;829;106
Hovedstaden;2020-03-14;F;8;1;3;13;837;109
Midtjylland;2020-03-14;F;4;0;1;13;841;110
Nordjylland;2020-03-14;F;2;0;2;13;843;112
Sjælland;2020-03-14;F;3;0;3;13;846;115
Syddanmark;2020-03-14;F;2;0;1;13;848;116
Hovedstaden;2020-03-14;M;8;2;6;15;856;122
Midtjylland;2020-03-14;M;2;0;1;15;858;123
Nordjylland;2020-03-14;M;1;0;1;15;859;124
Sjælland;2020-03-14;M;4;1;1;16;863;125
Syddanmark;2020-03-14;M;3;0;2;16;866;127
Hovedstaden;2020-03-15;F;8;1;4;17;874;131
Midtjylland;2020-03-15;F;3;1;2;18;877;133
Nordjylland;2020-03-15;F;1;0;1;18;878;134
Sjælland;2020-03-15;F;6;0;2;18;884;136
Syddanmark;2020-03-15;F;1;0;1;18;885;137
Hovedstaden;2020-03-15;M;17;2;12;20;902;149
Midtjylland;2020-03-15;M;1;0;0;20;903;149
Nordjylland;2020-03-15;M;2;0;2;20;905;151
Sjælland;2020-03-15;M;4;2;3;22;909;154
Syddanmark;2020-03-15;M;2;0;2;22;911;156
Hovedstaden;2020-03-16;F;27;1;10;23;938;166
Midtjylland;2020-03-16;F;1;0;1;23;939;167
Sjælland;2020-03-16;F;9;1;7;24;948;174
Hovedstaden;2020-03-16;M;23;6;18;30;971;192
Midtjylland;2020-03-16;M;1;1;1;31;972;193
Nordjylland;2020-03-16;M;1;0;1;31;973;194
Sjælland;2020-03-16;M;6;1;5;32;979;199
Syddanmark;2020-03-16;M;6;2;6;34;985;205
Hovedstaden;2020-03-17;F;23;2;10;36;1008;215
Midtjylland;2020-03-17;F;1;0;1;36;1009;216
Nordjylland;2020-03-17;F;2;0;2;36;1011;218
Sjælland;2020-03-17;F;4;1;4;37;1015;222
Syddanmark;2020-03-17;F;3;0;3;37;1018;225
Hovedstaden;2020-03-17;M;26;7;19;44;1044;244
Midtjylland;2020-03-17;M;6;1;5;45;1050;249
Nordjylland;2020-03-17;M;2;1;2;46;1052;251
Sjælland;2020-03-17;M;6;2;6;48;1058;257
Syddanmark;2020-03-17;M;3;1;2;49;1061;259
Hovedstaden;2020-03-18;F;16;2;8;51;1077;267
Midtjylland;2020-03-18;F;8;0;4;51;1085;271
Nordjylland;2020-03-18;F;3;0;2;51;1088;273
Sjælland;2020-03-18;F;6;0;5;51;1094;278
Syddanmark;2020-03-18;F;1;0;1;51;1095;279
Hovedstaden;2020-03-18;M;32;7;16;58;1127;295
Midtjylland;2020-03-18;M;3;1;1;59;1130;296
Nordjylland;2020-03-18;M;3;1;2;60;1133;298
Sjælland;2020-03-18;M;8;3;8;63;1141;306
Syddanmark;2020-03-18;M;3;1;2;64;1144;308
Hovedstaden;2020-03-19;F;30;1;12;65;1174;320
Midtjylland;2020-03-19;F;19;0;3;65;1193;323
Nordjylland;2020-03-19;F;2;0;2;65;1195;325
Sjælland;2020-03-19;F;2;0;1;65;1197;326
Syddanmark;2020-03-19;F;8;0;0;65;1205;326
Hovedstaden;2020-03-19;M;25;5;15;70;1230;341
Midtjylland;2020-03-19;M;5;0;1;70;1235;342
Nordjylland;2020-03-19;M;3;0;3;70;1238;345
Sjælland;2020-03-19;M;4;1;2;71;1242;347
Syddanmark;2020-03-19;M;8;0;6;71;1250;353
Hovedstaden;2020-03-20;F;32;4;17;75;1282;370
Midtjylland;2020-03-20;F;3;0;3;75;1285;373
Nordjylland;2020-03-20;F;2;0;0;75;1287;373
Sjælland;2020-03-20;F;8;1;5;76;1295;378
Syddanmark;2020-03-20;F;6;0;3;76;1301;381
Hovedstaden;2020-03-20;M;23;3;15;79;1324;396
Midtjylland;2020-03-20;M;6;0;2;79;1330;398
Nordjylland;2020-03-20;M;3;1;2;80;1333;400
Sjælland;2020-03-20;M;11;2;10;82;1344;410
Syddanmark;2020-03-20;M;8;0;7;82;1352;417
Hovedstaden;2020-03-21;F;15;2;6;84;1367;423
Midtjylland;2020-03-21;F;2;0;2;84;1369;425
Nordjylland;2020-03-21;F;1;0;1;84;1370;426
Sjælland;2020-03-21;F;5;0;4;84;1375;430
Syddanmark;2020-03-21;F;3;0;1;84;1378;431
Hovedstaden;2020-03-21;M;13;1;7;85;1391;438
Midtjylland;2020-03-21;M;3;0;3;85;1394;441
Sjælland;2020-03-21;M;3;1;2;86;1397;443
Syddanmark;2020-03-21;M;3;0;3;86;1400;446
Hovedstaden;2020-03-22;F;15;2;11;88;1415;457
Midtjylland;2020-03-22;F;3;0;3;88;1418;460
Nordjylland;2020-03-22;F;1;1;1;89;1419;461
Sjælland;2020-03-22;F;5;1;4;90;1424;465
Syddanmark;2020-03-22;F;1;0;1;90;1425;466
Hovedstaden;2020-03-22;M;20;5;10;95;1445;476
Midtjylland;2020-03-22;M;6;0;5;95;1451;481
Nordjylland;2020-03-22;M;1;0;1;95;1452;482
Sjælland;2020-03-22;M;6;2;5;97;1458;487
Syddanmark;2020-03-22;M;4;0;2;97;1462;489
Hovedstaden;2020-03-23;F;38;2;17;99;1500;506
Midtjylland;2020-03-23;F;11;0;9;99;1511;515
Nordjylland;2020-03-23;F;6;1;2;100;1517;517
Sjælland;2020-03-23;F;5;0;2;100;1522;519
Syddanmark;2020-03-23;F;1;0;0;100;1523;519
Hovedstaden;2020-03-23;M;34;3;21;103;1557;540
Midtjylland;2020-03-23;M;10;2;9;105;1567;549
Nordjylland;2020-03-23;M;4;0;4;105;1571;553
Sjælland;2020-03-23;M;12;3;8;108;1583;561
Syddanmark;2020-03-23;M;10;2;10;110;1593;571
Hovedstaden;2020-03-24;F;35;4;12;114;1628;583
Midtjylland;2020-03-24;F;7;0;5;114;1635;588
Nordjylland;2020-03-24;F;1;0;1;114;1636;589
Sjælland;2020-03-24;F;5;0;2;114;1641;591
Syddanmark;2020-03-24;F;11;0;7;114;1652;598
Hovedstaden;2020-03-24;M;39;4;27;118;1691;625
Midtjylland;2020-03-24;M;9;2;8;120;1700;633
Nordjylland;2020-03-24;M;6;0;6;120;1706;639
Sjælland;2020-03-24;M;13;3;10;123;1719;649
Syddanmark;2020-03-24;M;12;0;7;123;1731;656
Hovedstaden;2020-03-25;F;40;5;18;128;1771;674
Midtjylland;2020-03-25;F;8;0;2;128;1779;676
Nordjylland;2020-03-25;F;3;0;2;128;1782;678
Sjælland;2020-03-25;F;15;0;11;128;1797;689
Syddanmark;2020-03-25;F;8;0;3;128;1805;692
Hovedstaden;2020-03-25;M;33;9;23;137;1838;715
Midtjylland;2020-03-25;M;14;1;10;138;1852;725
Nordjylland;2020-03-25;M;5;1;4;139;1857;729
Sjælland;2020-03-25;M;14;4;11;143;1871;740
Syddanmark;2020-03-25;M;11;2;7;145;1882;747
Hovedstaden;2020-03-26;F;53;8;18;153;1935;765
Midtjylland;2020-03-26;F;14;3;6;156;1949;771
Nordjylland;2020-03-26;F;7;0;5;156;1956;776
Sjælland;2020-03-26;F;13;1;9;157;1969;785
Syddanmark;2020-03-26;F;10;0;4;157;1979;789
Hovedstaden;2020-03-26;M;36;5;23;162;2015;812
Midtjylland;2020-03-26;M;13;1;9;163;2028;821
Nordjylland;2020-03-26;M;5;0;3;163;2033;824
Sjælland;2020-03-26;M;6;2;3;165;2039;827
Syddanmark;2020-03-26;M;13;1;5;166;2052;832
Hovedstaden;2020-03-27;F;70;1;18;167;2122;850
Midtjylland;2020-03-27;F;11;0;1;167;2133;851
Nordjylland;2020-03-27;F;7;0;3;167;2140;854
Sjælland;2020-03-27;F;16;2;7;169;2156;861
Syddanmark;2020-03-27;F;14;0;6;169;2170;867
Hovedstaden;2020-03-27;M;51;4;27;173;2221;894
Midtjylland;2020-03-27;M;14;1;10;174;2235;904
Nordjylland;2020-03-27;M;3;0;0;174;2238;904
Sjælland;2020-03-27;M;12;0;8;174;2250;912
Syddanmark;2020-03-27;M;17;2;13;176;2267;925
Hovedstaden;2020-03-28;F;68;3;19;179;2335;944
Midtjylland;2020-03-28;F;12;0;2;179;2347;946
Nordjylland;2020-03-28;F;5;0;1;179;2352;947
Sjælland;2020-03-28;F;13;1;8;180;2365;955
Syddanmark;2020-03-28;F;14;1;10;181;2379;965
Hovedstaden;2020-03-28;M;53;8;25;189;2432;990
Midtjylland;2020-03-28;M;9;3;7;192;2441;997
Nordjylland;2020-03-28;M;6;1;4;193;2447;1001
Sjælland;2020-03-28;M;11;2;10;195;2458;1011
Syddanmark;2020-03-28;M;9;0;7;195;2467;1018
Hovedstaden;2020-03-29;F;51;3;14;198;2518;1032
Midtjylland;2020-03-29;F;3;1;2;199;2521;1034
Nordjylland;2020-03-29;F;4;2;1;201;2525;1035
Sjælland;2020-03-29;F;7;1;6;202;2532;1041
Syddanmark;2020-03-29;F;5;0;5;202;2537;1046
Hovedstaden;2020-03-29;M;32;1;8;203;2569;1054
Midtjylland;2020-03-29;M;5;1;3;204;2574;1057
Nordjylland;2020-03-29;M;5;1;3;205;2579;1060
Sjælland;2020-03-29;M;8;3;8;208;2587;1068
Syddanmark;2020-03-29;M;7;0;4;208;2594;1072
Hovedstaden;2020-03-30;F;97;9;24;217;2691;1096
Midtjylland;2020-03-30;F;25;2;4;219;2716;1100
Nordjylland;2020-03-30;F;8;0;2;219;2724;1102
Sjælland;2020-03-30;F;37;3;6;222;2761;1108
Syddanmark;2020-03-30;F;24;1;7;223;2785;1115
Hovedstaden;2020-03-30;M;64;4;22;227;2849;1137
Midtjylland;2020-03-30;M;16;2;6;229;2865;1143
Nordjylland;2020-03-30;M;3;0;0;229;2868;1143
Sjælland;2020-03-30;M;19;3;9;232;2887;1152
Syddanmark;2020-03-30;M;16;1;4;233;2903;1156
Hovedstaden;2020-03-31;F;74;8;21;241;2977;1177
Midtjylland;2020-03-31;F;39;0;6;241;3016;1183
Nordjylland;2020-03-31;F;15;2;2;243;3031;1185
Sjælland;2020-03-31;F;19;1;6;244;3050;1191
Syddanmark;2020-03-31;F;11;1;2;245;3061;1193
Hovedstaden;2020-03-31;M;50;3;16;248;3111;1209
Midtjylland;2020-03-31;M;11;3;7;251;3122;1216
Nordjylland;2020-03-31;M;3;1;0;252;3125;1216
Sjælland;2020-03-31;M;19;1;3;253;3144;1219
Syddanmark;2020-03-31;M;13;2;4;255;3157;1223
Hovedstaden;2020-04-01;F;89;6;15;261;3246;1238
Midtjylland;2020-04-01;F;40;2;4;263;3286;1242
Nordjylland;2020-04-01;F;13;1;2;264;3299;1244
Sjælland;2020-04-01;F;21;0;7;264;3320;1251
Syddanmark;2020-04-01;F;26;2;5;266;3346;1256
Hovedstaden;2020-04-01;M;51;2;12;268;3397;1268
Midtjylland;2020-04-01;M;14;1;4;269;3411;1272
Nordjylland;2020-04-01;M;3;0;3;269;3414;1275
Sjælland;2020-04-01;M;12;0;2;269;3426;1277
Syddanmark;2020-04-01;M;10;1;4;270;3436;1281
Hovedstaden;2020-04-02;F;120;3;20;273;3556;1301
Midtjylland;2020-04-02;F;36;1;4;274;3592;1305
Nordjylland;2020-04-02;F;18;0;1;274;3610;1306
Sjælland;2020-04-02;F;41;4;6;278;3651;1312
Syddanmark;2020-04-02;F;33;1;6;279;3684;1318
Hovedstaden;2020-04-02;M;66;5;17;284;3750;1335
Midtjylland;2020-04-02;M;14;1;3;285;3764;1338
Nordjylland;2020-04-02;M;8;1;6;286;3772;1344
Sjælland;2020-04-02;M;24;0;7;286;3796;1351
Syddanmark;2020-04-02;M;20;1;2;287;3816;1353
Hovedstaden;2020-04-03;F;169;5;20;292;3985;1373
Midtjylland;2020-04-03;F;46;0;7;292;4031;1380
Nordjylland;2020-04-03;F;19;1;7;293;4050;1387
Sjælland;2020-04-03;F;34;1;2;294;4084;1389
Syddanmark;2020-04-03;F;40;0;3;294;4124;1392
Hovedstaden;2020-04-03;M;89;6;18;300;4213;1410
Midtjylland;2020-04-03;M;25;2;4;302;4238;1414
Nordjylland;2020-04-03;M;9;1;2;303;4247;1416
Sjælland;2020-04-03;M;18;0;4;303;4265;1420
Syddanmark;2020-04-03;M;22;0;7;303;4287;1427
Hovedstaden;2020-04-04;F;127;2;12;305;4414;1439
Midtjylland;2020-04-04;F;19;1;4;306;4433;1443
Nordjylland;2020-04-04;F;2;0;0;306;4435;1443
Sjælland;2020-04-04;F;21;1;5;307;4456;1448
Syddanmark;2020-04-04;F;12;0;1;307;4468;1449
Hovedstaden;2020-04-04;M;86;6;22;313;4554;1471
Midtjylland;2020-04-04;M;11;3;4;316;4565;1475
Nordjylland;2020-04-04;M;6;1;4;317;4571;1479
Sjælland;2020-04-04;M;5;1;3;318;4576;1482
Syddanmark;2020-04-04;M;4;0;1;318;4580;1483
Hovedstaden;2020-04-05;F;64;6;16;324;4644;1499
Midtjylland;2020-04-05;F;18;0;4;324;4662;1503
Nordjylland;2020-04-05;F;3;1;0;325;4665;1503
Sjælland;2020-04-05;F;13;0;2;325;4678;1505
Syddanmark;2020-04-05;F;9;0;1;325;4687;1506
Hovedstaden;2020-04-05;M;38;4;8;329;4725;1514
Midtjylland;2020-04-05;M;2;0;0;329;4727;1514
Nordjylland;2020-04-05;M;2;0;1;329;4729;1515
Sjælland;2020-04-05;M;5;0;1;329;4734;1516
Syddanmark;2020-04-05;M;3;1;2;330;4737;1518
Hovedstaden;2020-04-06;F;128;4;18;334;4865;1536
Midtjylland;2020-04-06;F;44;1;4;335;4909;1540
Nordjylland;2020-04-06;F;10;0;0;335;4919;1540
Sjælland;2020-04-06;F;52;2;9;337;4971;1549
Syddanmark;2020-04-06;F;25;1;1;338;4996;1550
Hovedstaden;2020-04-06;M;93;4;12;342;5089;1562
Midtjylland;2020-04-06;M;27;2;4;344;5116;1566
Nordjylland;2020-04-06;M;11;0;1;344;5127;1567
Sjælland;2020-04-06;M;11;0;2;344;5138;1569
Syddanmark;2020-04-06;M;22;0;5;344;5160;1574
Hovedstaden;2020-04-07;F;105;6;20;350;5265;1594
Midtjylland;2020-04-07;F;41;1;4;351;5306;1598
Nordjylland;2020-04-07;F;3;0;0;351;5309;1598
Sjælland;2020-04-07;F;30;0;3;351;5339;1601
Syddanmark;2020-04-07;F;24;0;4;351;5363;1605
Hovedstaden;2020-04-07;M;77;3;12;354;5440;1617
Midtjylland;2020-04-07;M;25;2;2;356;5465;1619
Nordjylland;2020-04-07;M;6;0;1;356;5471;1620
Sjælland;2020-04-07;M;23;0;4;356;5494;1624
Syddanmark;2020-04-07;M;11;0;0;356;5505;1624
Hovedstaden;2020-04-08;F;110;2;12;358;5615;1636
Midtjylland;2020-04-08;F;29;1;3;359;5644;1639
Nordjylland;2020-04-08;F;6;0;0;359;5650;1639
Sjælland;2020-04-08;F;36;0;6;359;5686;1645
Syddanmark;2020-04-08;F;16;1;0;360;5702;1645
Hovedstaden;2020-04-08;M;56;3;8;363;5758;1653
Midtjylland;2020-04-08;M;21;0;3;363;5779;1656
Nordjylland;2020-04-08;M;1;0;0;363;5780;1656
Sjælland;2020-04-08;M;16;2;5;365;5796;1661
Syddanmark;2020-04-08;M;3;0;0;365;5799;1661
Hovedstaden;2020-04-09;F;52;2;11;367;5851;1672
Midtjylland;2020-04-09;F;12;0;2;367;5863;1674
Nordjylland;2020-04-09;F;4;0;0;367;5867;1674
Sjælland;2020-04-09;F;10;1;5;368;5877;1679
Syddanmark;2020-04-09;F;8;0;2;368;5885;1681
Hovedstaden;2020-04-09;M;22;1;2;369;5907;1683
Midtjylland;2020-04-09;M;11;1;3;370;5918;1686
Nordjylland;2020-04-09;M;4;0;0;370;5922;1686
Sjælland;2020-04-09;M;9;1;3;371;5931;1689
Syddanmark;2020-04-09;M;4;0;0;371;5935;1689
Hovedstaden;2020-04-10;F;54;1;4;372;5989;1693
Midtjylland;2020-04-10;F;12;0;2;372;6001;1695
Nordjylland;2020-04-10;F;4;0;1;372;6005;1696
Sjælland;2020-04-10;F;16;0;1;372;6021;1697
Syddanmark;2020-04-10;F;1;0;0;372;6022;1697
Hovedstaden;2020-04-10;M;34;1;3;373;6056;1700
Midtjylland;2020-04-10;M;5;0;1;373;6061;1701
Nordjylland;2020-04-10;M;3;0;1;373;6064;1702
Sjælland;2020-04-10;M;5;1;5;374;6069;1707
Syddanmark;2020-04-10;M;6;0;1;374;6075;1708
Hovedstaden;2020-04-11;F;34;2;6;376;6109;1714
Midtjylland;2020-04-11;F;23;1;3;377;6132;1717
Nordjylland;2020-04-11;F;2;0;1;377;6134;1718
Sjælland;2020-04-11;F;8;1;4;378;6142;1722
Syddanmark;2020-04-11;F;8;0;2;378;6150;1724
Hovedstaden;2020-04-11;M;40;3;8;381;6190;1732
Midtjylland;2020-04-11;M;11;2;4;383;6201;1736
Sjælland;2020-04-11;M;7;0;2;383;6208;1738
Syddanmark;2020-04-11;M;6;1;3;384;6214;1741
Hovedstaden;2020-04-12;F;64;3;8;387;6278;1749
Midtjylland;2020-04-12;F;13;2;2;389;6291;1751
Nordjylland;2020-04-12;F;5;0;1;389;6296;1752
Sjælland;2020-04-12;F;17;0;4;389;6313;1756
Syddanmark;2020-04-12;F;7;0;1;389;6320;1757
Hovedstaden;2020-04-12;M;31;1;3;390;6351;1760
Midtjylland;2020-04-12;M;8;0;1;390;6359;1761
Nordjylland;2020-04-12;M;3;0;2;390;6362;1763
Sjælland;2020-04-12;M;2;0;0;390;6364;1763
Syddanmark;2020-04-12;M;6;0;1;390;6370;1764
Hovedstaden;2020-04-13;F;57;3;5;393;6427;1769
Midtjylland;2020-04-13;F;20;0;2;393;6447;1771
Nordjylland;2020-04-13;F;4;0;0;393;6451;1771
Sjælland;2020-04-13;F;11;1;3;394;6462;1774
Syddanmark;2020-04-13;F;4;0;1;394;6466;1775
Hovedstaden;2020-04-13;M;39;4;13;398;6505;1788
Midtjylland;2020-04-13;M;11;0;2;398;6516;1790
Nordjylland;2020-04-13;M;1;0;0;398;6517;1790
Sjælland;2020-04-13;M;7;1;5;399;6524;1795
Syddanmark;2020-04-13;M;2;0;1;399;6526;1796
Hovedstaden;2020-04-14;F;88;5;13;404;6614;1809
Midtjylland;2020-04-14;F;30;0;3;404;6644;1812
Nordjylland;2020-04-14;F;2;0;0;404;6646;1812
Sjælland;2020-04-14;F;35;0;4;404;6681;1816
Syddanmark;2020-04-14;F;17;1;2;405;6698;1818
Hovedstaden;2020-04-14;M;46;1;6;406;6744;1824
Midtjylland;2020-04-14;M;16;3;5;409;6760;1829
Sjælland;2020-04-14;M;16;1;3;410;6776;1832
Syddanmark;2020-04-14;M;8;0;0;410;6784;1832
Hovedstaden;2020-04-15;F;79;5;6;415;6863;1838
Midtjylland;2020-04-15;F;17;1;1;416;6880;1839
Nordjylland;2020-04-15;F;4;0;0;416;6884;1839
Sjælland;2020-04-15;F;20;0;5;416;6904;1844
Syddanmark;2020-04-15;F;8;0;1;416;6912;1845
Hovedstaden;2020-04-15;M;40;2;4;418;6952;1849
Midtjylland;2020-04-15;M;10;1;2;419;6962;1851
Nordjylland;2020-04-15;M;4;0;0;419;6966;1851
Sjælland;2020-04-15;M;10;2;5;421;6976;1856
Syddanmark;2020-04-15;M;6;0;1;421;6982;1857
Hovedstaden;2020-04-16;F;53;1;7;422;7035;1864
Midtjylland;2020-04-16;F;26;0;2;422;7061;1866
Nordjylland;2020-04-16;F;4;0;0;422;7065;1866
Sjælland;2020-04-16;F;16;2;5;424;7081;1871
Syddanmark;2020-04-16;F;8;0;1;424;7089;1872
Hovedstaden;2020-04-16;M;37;2;8;426;7126;1880
Midtjylland;2020-04-16;M;16;1;2;427;7142;1882
Nordjylland;2020-04-16;M;1;0;0;427;7143;1882
Sjælland;2020-04-16;M;8;0;0;427;7151;1882
Syddanmark;2020-04-16;M;9;0;1;427;7160;1883
Hovedstaden;2020-04-17;F;51;1;7;428;7211;1890
Midtjylland;2020-04-17;F;18;1;1;429;7229;1891
Nordjylland;2020-04-17;F;2;0;0;429;7231;1891
Sjælland;2020-04-17;F;29;2;7;431;7260;1898
Syddanmark;2020-04-17;F;8;0;2;431;7268;1900
Hovedstaden;2020-04-17;M;37;3;7;434;7305;1907
Midtjylland;2020-04-17;M;5;0;0;434;7310;1907
Nordjylland;2020-04-17;M;2;1;0;435;7312;1907
Sjælland;2020-04-17;M;14;1;4;436;7326;1911
Syddanmark;2020-04-17;M;2;0;0;436;7328;1911
Hovedstaden;2020-04-18;F;37;1;7;437;7365;1918
Midtjylland;2020-04-18;F;13;0;3;437;7378;1921
Nordjylland;2020-04-18;F;2;0;1;437;7380;1922
Sjælland;2020-04-18;F;15;1;2;438;7395;1924
Hovedstaden;2020-04-18;M;23;3;7;441;7418;1931
Midtjylland;2020-04-18;M;4;0;0;441;7422;1931
Sjælland;2020-04-18;M;7;2;4;443;7429;1935
Syddanmark;2020-04-18;M;3;0;0;443;7432;1935
Hovedstaden;2020-04-19;F;37;1;7;444;7469;1942
Midtjylland;2020-04-19;F;8;0;2;444;7477;1944
Sjælland;2020-04-19;F;19;0;4;444;7496;1948
Syddanmark;2020-04-19;F;3;0;0;444;7499;1948
Hovedstaden;2020-04-19;M;24;1;9;445;7523;1957
Midtjylland;2020-04-19;M;7;0;1;445;7530;1958
Nordjylland;2020-04-19;M;2;0;0;445;7532;1958
Sjælland;2020-04-19;M;10;3;7;448;7542;1965
Syddanmark;2020-04-19;M;1;0;0;448;7543;1965
Hovedstaden;2020-04-20;F;89;5;8;453;7632;1973
Midtjylland;2020-04-20;F;15;0;1;453;7647;1974
Nordjylland;2020-04-20;F;5;0;0;453;7652;1974
Sjælland;2020-04-20;F;26;1;7;454;7678;1981
Syddanmark;2020-04-20;F;3;0;0;454;7681;1981
Hovedstaden;2020-04-20;M;50;3;11;457;7731;1992
Midtjylland;2020-04-20;M;11;1;2;458;7742;1994
Nordjylland;2020-04-20;M;1;0;0;458;7743;1994
Sjælland;2020-04-20;M;10;1;5;459;7753;1999
Syddanmark;2020-04-20;M;3;2;2;461;7756;2001
Hovedstaden;2020-04-21;F;66;3;10;464;7822;2011
Midtjylland;2020-04-21;F;10;0;0;464;7832;2011
Nordjylland;2020-04-21;F;4;1;0;465;7836;2011
Sjælland;2020-04-21;F;31;1;7;466;7867;2018
Syddanmark;2020-04-21;F;7;0;1;466;7874;2019
Hovedstaden;2020-04-21;M;54;5;6;471;7928;2025
Midtjylland;2020-04-21;M;8;1;2;472;7936;2027
Nordjylland;2020-04-21;M;1;0;0;472;7937;2027
Sjælland;2020-04-21;M;15;1;7;473;7952;2034
Syddanmark;2020-04-21;M;5;0;0;473;7957;2034
Hovedstaden;2020-04-22;F;87;3;9;476;8044;2043
Midtjylland;2020-04-22;F;17;0;2;476;8061;2045
Nordjylland;2020-04-22;F;5;0;0;476;8066;2045
Sjælland;2020-04-22;F;22;2;4;478;8088;2049
Syddanmark;2020-04-22;F;1;0;0;478;8089;2049
Hovedstaden;2020-04-22;M;66;6;12;484;8155;2061
Midtjylland;2020-04-22;M;15;1;4;485;8170;2065
Sjælland;2020-04-22;M;12;1;3;486;8182;2068
Syddanmark;2020-04-22;M;1;0;0;486;8183;2068
Hovedstaden;2020-04-23;F;89;4;10;490;8272;2078
Midtjylland;2020-04-23;F;22;1;1;491;8294;2079
Nordjylland;2020-04-23;F;2;0;0;491;8296;2079
Sjælland;2020-04-23;F;30;1;6;492;8326;2085
Syddanmark;2020-04-23;F;4;0;0;492;8330;2085
Hovedstaden;2020-04-23;M;49;1;7;493;8379;2092
Midtjylland;2020-04-23;M;10;0;1;493;8389;2093
Nordjylland;2020-04-23;M;1;0;0;493;8390;2093
Sjælland;2020-04-23;M;20;0;7;493;8410;2100
Syddanmark;2020-04-23;M;4;0;0;493;8414;2100
Hovedstaden;2020-04-24;F;61;2;8;495;8475;2108
Midtjylland;2020-04-24;F;19;1;1;496;8494;2109
Sjælland;2020-04-24;F;23;2;5;498;8517;2114
Syddanmark;2020-04-24;F;2;0;0;498;8519;2114
Hovedstaden;2020-04-24;M;34;1;4;499;8553;2118
Midtjylland;2020-04-24;M;8;1;0;500;8561;2118
Nordjylland;2020-04-24;M;2;0;0;500;8563;2118
Sjælland;2020-04-24;M;12;1;3;501;8575;2121
Syddanmark;2020-04-24;M;3;0;0;501;8578;2121
Hovedstaden;2020-04-25;F;38;1;5;502;8616;2126
Midtjylland;2020-04-25;F;22;1;0;503;8638;2126
Nordjylland;2020-04-25;F;4;0;1;503;8642;2127
Sjælland;2020-04-25;F;14;1;4;504;8656;2131
Syddanmark;2020-04-25;F;3;0;0;504;8659;2131
Hovedstaden;2020-04-25;M;31;2;6;506;8690;2137
Midtjylland;2020-04-25;M;7;0;1;506;8697;2138
Nordjylland;2020-04-25;M;1;0;0;506;8698;2138
Sjælland;2020-04-25;M;9;2;2;508;8707;2140
Syddanmark;2020-04-25;M;5;0;0;508;8712;2140
Hovedstaden;2020-04-26;F;42;1;12;509;8754;2152
Midtjylland;2020-04-26;F;10;0;0;509;8764;2152
Nordjylland;2020-04-26;F;4;0;0;509;8768;2152
Sjælland;2020-04-26;F;13;0;2;509;8781;2154
Syddanmark;2020-04-26;F;4;0;0;509;8785;2154
Hovedstaden;2020-04-26;M;33;3;7;512;8818;2161
Midtjylland;2020-04-26;M;5;0;2;512;8823;2163
Sjælland;2020-04-26;M;5;1;1;513;8828;2164
Syddanmark;2020-04-26;M;3;0;0;513;8831;2164
Hovedstaden;2020-04-27;F;70;1;2;514;8901;2166
Midtjylland;2020-04-27;F;9;0;1;514;8910;2167
Nordjylland;2020-04-27;F;3;0;0;514;8913;2167
Sjælland;2020-04-27;F;36;4;5;518;8949;2172
Syddanmark;2020-04-27;F;1;0;0;518;8950;2172
Hovedstaden;2020-04-27;M;59;2;7;520;9009;2179
Midtjylland;2020-04-27;M;9;0;2;520;9018;2181
Nordjylland;2020-04-27;M;2;0;0;520;9020;2181
Sjælland;2020-04-27;M;25;5;5;525;9045;2186
Syddanmark;2020-04-27;M;3;0;0;525;9048;2186
Hovedstaden;2020-04-28;F;51;2;7;527;9099;2193
Midtjylland;2020-04-28;F;17;0;0;527;9116;2193
Sjælland;2020-04-28;F;22;0;0;527;9138;2193
Hovedstaden;2020-04-28;M;32;0;3;527;9170;2196
Midtjylland;2020-04-28;M;7;0;0;527;9177;2196
Sjælland;2020-04-28;M;7;0;0;527;9184;2196
Hovedstaden;2020-04-29;F;50;2;6;529;9234;2202
Midtjylland;2020-04-29;F;10;1;1;530;9244;2203
Nordjylland;2020-04-29;F;1;0;0;530;9245;2203
Sjælland;2020-04-29;F;16;0;1;530;9261;2204
Syddanmark;2020-04-29;F;4;0;0;530;9265;2204
Hovedstaden;2020-04-29;M;42;4;11;534;9307;2215
Midtjylland;2020-04-29;M;7;0;0;534;9314;2215
Nordjylland;2020-04-29;M;2;0;0;534;9316;2215
Sjælland;2020-04-29;M;5;1;2;535;9321;2217
Syddanmark;2020-04-29;M;2;0;0;535;9323;2217
Hovedstaden;2020-04-30;F;62;0;6;535;9385;2223
Midtjylland;2020-04-30;F;6;0;1;535;9391;2224
Nordjylland;2020-04-30;F;3;0;0;535;9394;2224
Sjælland;2020-04-30;F;23;0;3;535;9417;2227
Syddanmark;2020-04-30;F;1;0;0;535;9418;2227
Hovedstaden;2020-04-30;M;33;0;5;535;9451;2232
Midtjylland;2020-04-30;M;7;0;0;535;9458;2232
Nordjylland;2020-04-30;M;2;0;1;535;9460;2233
Sjælland;2020-04-30;M;8;0;0;535;9468;2233
Syddanmark;2020-04-30;M;1;0;0;535;9469;2233
Hovedstaden;2020-05-01;F;58;2;3;537;9527;2236
Midtjylland;2020-05-01;F;5;0;0;537;9532;2236
Nordjylland;2020-05-01;F;10;0;0;537;9542;2236
Sjælland;2020-05-01;F;15;1;1;538;9557;2237
Syddanmark;2020-05-01;F;2;0;0;538;9559;2237
Hovedstaden;2020-05-01;M;25;0;2;538;9584;2239
Midtjylland;2020-05-01;M;11;0;1;538;9595;2240
Nordjylland;2020-05-01;M;9;0;0;538;9604;2240
Sjælland;2020-05-01;M;10;1;2;539;9614;2242
Syddanmark;2020-05-01;M;3;0;1;539;9617;2243
Hovedstaden;2020-05-02;F;31;0;2;539;9648;2245
Midtjylland;2020-05-02;F;12;0;3;539;9660;2248
Nordjylland;2020-05-02;F;1;0;0;539;9661;2248
Sjælland;2020-05-02;F;17;0;1;539;9678;2249
Syddanmark;2020-05-02;F;4;0;0;539;9682;2249
Hovedstaden;2020-05-02;M;27;1;4;540;9709;2253
Midtjylland;2020-05-02;M;8;0;2;540;9717;2255
Nordjylland;2020-05-02;M;1;0;0;540;9718;2255
Sjælland;2020-05-02;M;12;1;1;541;9730;2256
Syddanmark;2020-05-02;M;2;0;0;541;9732;2256
Hovedstaden;2020-05-03;F;33;0;7;541;9765;2263
Midtjylland;2020-05-03;F;4;0;1;541;9769;2264
Nordjylland;2020-05-03;F;1;0;0;541;9770;2264
Sjælland;2020-05-03;F;6;0;2;541;9776;2266
Syddanmark;2020-05-03;F;4;0;1;541;9780;2267
Hovedstaden;2020-05-03;M;17;2;2;543;9797;2269
Midtjylland;2020-05-03;M;6;0;1;543;9803;2270
Nordjylland;2020-05-03;M;1;0;0;543;9804;2270
Sjælland;2020-05-03;M;5;1;3;544;9809;2273
Syddanmark;2020-05-03;M;1;0;0;544;9810;2273
Hovedstaden;2020-05-04;F;50;0;3;544;9860;2276
Midtjylland;2020-05-04;F;5;0;1;544;9865;2277
Sjælland;2020-05-04;F;21;1;3;545;9886;2280
Syddanmark;2020-05-04;F;3;0;0;545;9889;2280
Hovedstaden;2020-05-04;M;29;0;3;545;9918;2283
Midtjylland;2020-05-04;M;3;0;1;545;9921;2284
Sjælland;2020-05-04;M;8;0;3;545;9929;2287
Syddanmark;2020-05-04;M;1;0;0;545;9930;2287
Hovedstaden;2020-05-05;F;32;1;4;546;9962;2291
Midtjylland;2020-05-05;F;5;0;0;546;9967;2291
Nordjylland;2020-05-05;F;2;0;0;546;9969;2291
Sjælland;2020-05-05;F;20;2;4;548;9989;2295
Syddanmark;2020-05-05;F;4;0;0;548;9993;2295
Hovedstaden;2020-05-05;M;40;2;5;550;10033;2300
Midtjylland;2020-05-05;M;3;0;0;550;10036;2300
Sjælland;2020-05-05;M;15;0;5;550;10051;2305
Syddanmark;2020-05-05;M;1;0;0;550;10052;2305
Hovedstaden;2020-05-06;F;55;0;1;550;10107;2306
Midtjylland;2020-05-06;F;2;0;0;550;10109;2306
Sjælland;2020-05-06;F;9;0;0;550;10118;2306
Syddanmark;2020-05-06;F;2;0;0;550;10120;2306
Hovedstaden;2020-05-06;M;27;0;4;550;10147;2310
Midtjylland;2020-05-06;M;4;0;0;550;10151;2310
Sjælland;2020-05-06;M;6;0;2;550;10157;2312
Hovedstaden;2020-05-07;F;44;0;2;550;10201;2314
Midtjylland;2020-05-07;F;5;0;0;550;10206;2314
Sjælland;2020-05-07;F;19;0;3;550;10225;2317
Syddanmark;2020-05-07;F;1;0;0;550;10226;2317
Hovedstaden;2020-05-07;M;32;0;4;550;10258;2321
Midtjylland;2020-05-07;M;5;0;0;550;10263;2321
Nordjylland;2020-05-07;M;1;0;0;550;10264;2321
Sjælland;2020-05-07;M;13;2;4;552;10277;2325
Syddanmark;2020-05-07;M;2;0;0;552;10279;2325
Hovedstaden;2020-05-08;F;31;3;4;555;10310;2329
Midtjylland;2020-05-08;F;4;0;0;555;10314;2329
Sjælland;2020-05-08;F;4;0;0;555;10318;2329
Syddanmark;2020-05-08;F;1;0;0;555;10319;2329
Hovedstaden;2020-05-08;M;21;1;4;556;10340;2333
Midtjylland;2020-05-08;M;1;0;0;556;10341;2333
Sjælland;2020-05-08;M;5;0;0;556;10346;2333
Syddanmark;2020-05-08;M;2;0;0;556;10348;2333
Hovedstaden;2020-05-09;F;24;1;5;557;10372;2338
Midtjylland;2020-05-09;F;2;0;2;557;10374;2340
Nordjylland;2020-05-09;F;1;0;0;557;10375;2340
Sjælland;2020-05-09;F;7;0;0;557;10382;2340
Hovedstaden;2020-05-09;M;24;1;5;558;10406;2345
Midtjylland;2020-05-09;M;2;0;0;558;10408;2345
Sjælland;2020-05-09;M;4;0;1;558;10412;2346
Hovedstaden;2020-05-10;F;20;0;2;558;10432;2348
Midtjylland;2020-05-10;F;2;0;0;558;10434;2348
Nordjylland;2020-05-10;F;2;0;0;558;10436;2348
Sjælland;2020-05-10;F;4;0;0;558;10440;2348
Syddanmark;2020-05-10;F;3;0;0;558;10443;2348
Hovedstaden;2020-05-10;M;18;0;2;558;10461;2350
Midtjylland;2020-05-10;M;1;0;0;558;10462;2350
Nordjylland;2020-05-10;M;2;0;0;558;10464;2350
Sjælland;2020-05-10;M;4;1;1;559;10468;2351
Syddanmark;2020-05-10;M;1;1;1;560;10469;2352
Hovedstaden;2020-05-11;F;28;0;4;560;10497;2356
Midtjylland;2020-05-11;F;2;0;1;560;10499;2357
Sjælland;2020-05-11;F;5;0;1;560;10504;2358
Syddanmark;2020-05-11;F;5;0;0;560;10509;2358
Hovedstaden;2020-05-11;M;22;0;1;560;10531;2359
Midtjylland;2020-05-11;M;1;0;0;560;10532;2359
Nordjylland;2020-05-11;M;1;0;0;560;10533;2359
Sjælland;2020-05-11;M;7;0;1;560;10540;2360
Syddanmark;2020-05-11;M;7;1;2;561;10547;2362
Hovedstaden;2020-05-12;F;20;0;4;561;10567;2366
Nordjylland;2020-05-12;F;1;0;0;561;10568;2366
Sjælland;2020-05-12;F;9;0;1;561;10577;2367
Syddanmark;2020-05-12;F;6;0;0;561;10583;2367
Hovedstaden;2020-05-12;M;15;1;1;562;10598;2368
Midtjylland;2020-05-12;M;1;0;0;562;10599;2368
Sjælland;2020-05-12;M;1;0;0;562;10600;2368
Syddanmark;2020-05-12;M;3;0;0;562;10603;2368
Hovedstaden;2020-05-13;F;26;1;1;563;10629;2369
Midtjylland;2020-05-13;F;3;0;1;563;10632;2370
Sjælland;2020-05-13;F;7;0;1;563;10639;2371
Syddanmark;2020-05-13;F;5;0;1;563;10644;2372
Hovedstaden;2020-05-13;M;15;0;0;563;10659;2372
Midtjylland;2020-05-13;M;1;0;0;563;10660;2372
Nordjylland;2020-05-13;M;1;0;0;563;10661;2372
Sjælland;2020-05-13;M;6;0;0;563;10667;2372
Syddanmark;2020-05-13;M;1;0;0;563;10668;2372
Hovedstaden;2020-05-14;F;22;0;2;563;10690;2374
Midtjylland;2020-05-14;F;1;0;0;563;10691;2374
Sjælland;2020-05-14;F;11;0;2;563;10702;2376
Syddanmark;2020-05-14;F;3;0;1;563;10705;2377
Hovedstaden;2020-05-14;M;13;0;2;563;10718;2379
Midtjylland;2020-05-14;M;3;0;0;563;10721;2379
Sjælland;2020-05-14;M;3;0;0;563;10724;2379
Syddanmark;2020-05-14;M;5;1;4;564;10729;2383
Hovedstaden;2020-05-15;F;26;1;2;565;10755;2385
Midtjylland;2020-05-15;F;4;0;0;565;10759;2385
Nordjylland;2020-05-15;F;1;0;1;565;10760;2386
Sjælland;2020-05-15;F;5;1;3;566;10765;2389
Syddanmark;2020-05-15;F;3;0;0;566;10768;2389
Hovedstaden;2020-05-15;M;32;0;3;566;10800;2392
Sjælland;2020-05-15;M;9;2;2;568;10809;2394
Syddanmark;2020-05-15;M;9;1;1;569;10818;2395
Hovedstaden;2020-05-16;F;8;0;0;569;10826;2395
Midtjylland;2020-05-16;F;3;0;1;569;10829;2396
Nordjylland;2020-05-16;F;1;0;0;569;10830;2396
Sjælland;2020-05-16;F;5;1;1;570;10835;2397
Syddanmark;2020-05-16;F;1;0;0;570;10836;2397
Hovedstaden;2020-05-16;M;10;0;0;570;10846;2397
Midtjylland;2020-05-16;M;1;0;0;570;10847;2397
Sjælland;2020-05-16;M;3;0;1;570;10850;2398
Syddanmark;2020-05-16;M;2;0;1;570;10852;2399
Hovedstaden;2020-05-17;F;18;0;2;570;10870;2401
Midtjylland;2020-05-17;F;5;0;2;570;10875;2403
Sjælland;2020-05-17;F;5;0;0;570;10880;2403
Syddanmark;2020-05-17;F;3;0;0;570;10883;2403
Hovedstaden;2020-05-17;M;13;0;1;570;10896;2404
Midtjylland;2020-05-17;M;3;0;0;570;10899;2404
Sjælland;2020-05-17;M;2;0;0;570;10901;2404
Syddanmark;2020-05-17;M;1;0;0;570;10902;2404
Hovedstaden;2020-05-18;F;31;1;3;571;10933;2407
Midtjylland;2020-05-18;F;4;0;2;571;10937;2409
Sjælland;2020-05-18;F;5;0;1;571;10942;2410
Syddanmark;2020-05-18;F;4;0;1;571;10946;2411
Hovedstaden;2020-05-18;M;23;1;1;572;10969;2412
Midtjylland;2020-05-18;M;3;0;1;572;10972;2413
Nordjylland;2020-05-18;M;1;0;0;572;10973;2413
Sjælland;2020-05-18;M;3;0;0;572;10976;2413
Syddanmark;2020-05-18;M;6;0;0;572;10982;2413
Hovedstaden;2020-05-19;F;24;0;3;572;11006;2416
Midtjylland;2020-05-19;F;1;0;1;572;11007;2417
Sjælland;2020-05-19;F;5;0;0;572;11012;2417
Syddanmark;2020-05-19;F;3;0;1;572;11015;2418
Hovedstaden;2020-05-19;M;18;1;1;573;11033;2419
Midtjylland;2020-05-19;M;4;0;0;573;11037;2419
Nordjylland;2020-05-19;M;2;0;0;573;11039;2419
Sjælland;2020-05-19;M;3;0;1;573;11042;2420
Syddanmark;2020-05-19;M;1;0;0;573;11043;2420
Hovedstaden;2020-05-20;F;27;2;4;575;11070;2424
Nordjylland;2020-05-20;F;1;0;0;575;11071;2424
Sjælland;2020-05-20;F;7;0;0;575;11078;2424
Syddanmark;2020-05-20;F;4;0;0;575;11082;2424
Hovedstaden;2020-05-20;M;25;2;3;577;11107;2427
Sjælland;2020-05-20;M;5;1;2;578;11112;2429
Hovedstaden;2020-05-21;F;11;0;1;578;11123;2430
Midtjylland;2020-05-21;F;1;0;1;578;11124;2431
Nordjylland;2020-05-21;F;1;0;1;578;11125;2432
Sjælland;2020-05-21;F;4;0;1;578;11129;2433
Hovedstaden;2020-05-21;M;13;0;2;578;11142;2435
Sjælland;2020-05-21;M;1;0;1;578;11143;2436
Hovedstaden;2020-05-22;F;29;3;7;581;11172;2443
Midtjylland;2020-05-22;F;1;0;0;581;11173;2443
Nordjylland;2020-05-22;F;2;0;0;581;11175;2443
Sjælland;2020-05-22;F;6;0;1;581;11181;2444
Syddanmark;2020-05-22;F;1;0;0;581;11182;2444
Hovedstaden;2020-05-22;M;19;1;4;582;11201;2448
Midtjylland;2020-05-22;M;2;0;1;582;11203;2449
Sjælland;2020-05-22;M;8;1;2;583;11211;2451
Syddanmark;2020-05-22;M;3;0;0;583;11214;2451
Hovedstaden;2020-05-23;F;14;0;2;583;11228;2453
Midtjylland;2020-05-23;F;1;0;0;583;11229;2453
Sjælland;2020-05-23;F;3;1;1;584;11232;2454
Hovedstaden;2020-05-23;M;16;0;4;584;11248;2458
Midtjylland;2020-05-23;M;2;0;2;584;11250;2460
Sjælland;2020-05-23;M;1;0;0;584;11251;2460
Hovedstaden;2020-05-24;F;15;0;2;584;11266;2462
Sjælland;2020-05-24;F;5;0;1;584;11271;2463
Syddanmark;2020-05-24;F;1;0;0;584;11272;2463
Hovedstaden;2020-05-24;M;13;0;3;584;11285;2466
Syddanmark;2020-05-24;M;1;0;0;584;11286;2466
Hovedstaden;2020-05-25;F;25;1;3;585;11311;2469
Midtjylland;2020-05-25;F;1;0;0;585;11312;2469
Sjælland;2020-05-25;F;2;0;0;585;11314;2469
Syddanmark;2020-05-25;F;2;0;1;585;11316;2470
Hovedstaden;2020-05-25;M;18;0;0;585;11334;2470
Nordjylland;2020-05-25;M;1;0;0;585;11335;2470
Sjælland;2020-05-25;M;3;0;0;585;11338;2470
Hovedstaden;2020-05-26;F;27;2;5;587;11365;2475
Nordjylland;2020-05-26;F;2;0;0;587;11367;2475
Sjælland;2020-05-26;F;7;0;0;587;11374;2475
Syddanmark;2020-05-26;F;3;0;2;587;11377;2477
Hovedstaden;2020-05-26;M;19;0;4;587;11396;2481
Midtjylland;2020-05-26;M;2;0;0;587;11398;2481
Syddanmark;2020-05-26;M;2;0;1;587;11400;2482
Hovedstaden;2020-05-27;F;24;1;3;588;11424;2485
Midtjylland;2020-05-27;F;1;0;0;588;11425;2485
Sjælland;2020-05-27;F;2;0;0;588;11427;2485
Hovedstaden;2020-05-27;M;18;1;5;589;11445;2490
Midtjylland;2020-05-27;M;1;0;0;589;11446;2490
Sjælland;2020-05-27;M;6;0;2;589;11452;2492
Hovedstaden;2020-05-28;F;19;0;2;589;11471;2494
Sjælland;2020-05-28;F;5;0;2;589;11476;2496
Syddanmark;2020-05-28;F;1;0;0;589;11477;2496
Hovedstaden;2020-05-28;M;9;1;3;590;11486;2499
Sjælland;2020-05-28;M;2;0;0;590;11488;2499
Syddanmark;2020-05-28;M;1;0;0;590;11489;2499
Hovedstaden;2020-05-29;F;15;1;1;591;11504;2500
Sjælland;2020-05-29;F;3;0;1;591;11507;2501
Syddanmark;2020-05-29;F;1;0;0;591;11508;2501
Hovedstaden;2020-05-29;M;13;2;2;593;11521;2503
Sjælland;2020-05-29;M;8;0;2;593;11529;2505
Syddanmark;2020-05-29;M;2;0;0;593;11531;2505
Hovedstaden;2020-05-30;F;9;0;2;593;11540;2507
Sjælland;2020-05-30;F;7;0;1;593;11547;2508
Hovedstaden;2020-05-30;M;14;1;2;594;11561;2510
Sjælland;2020-05-30;M;2;0;0;594;11563;2510
Syddanmark;2020-05-30;M;1;0;1;594;11564;2511
Hovedstaden;2020-05-31;F;10;0;1;594;11574;2512
Sjælland;2020-05-31;F;5;0;0;594;11579;2512
Hovedstaden;2020-05-31;M;6;0;0;594;11585;2512
Sjælland;2020-05-31;M;1;0;0;594;11586;2512
Hovedstaden;2020-06-01;F;16;0;1;594;11602;2513
Sjælland;2020-06-01;F;2;0;0;594;11604;2513
Hovedstaden;2020-06-01;M;6;0;1;594;11610;2514
Midtjylland;2020-06-01;M;3;0;1;594;11613;2515
Sjælland;2020-06-01;M;6;0;2;594;11619;2517
Syddanmark;2020-06-01;M;2;0;1;594;11621;2518
Hovedstaden;2020-06-02;F;23;0;0;594;11644;2518
Midtjylland;2020-06-02;F;2;0;0;594;11646;2518
Sjælland;2020-06-02;F;12;0;1;594;11658;2519
Syddanmark;2020-06-02;F;3;0;0;594;11661;2519
Hovedstaden;2020-06-02;M;9;0;0;594;11670;2519
Midtjylland;2020-06-02;M;1;0;0;594;11671;2519
Sjælland;2020-06-02;M;4;0;1;594;11675;2520
Syddanmark;2020-06-02;M;1;0;0;594;11676;2520
Hovedstaden;2020-06-03;F;24;0;1;594;11700;2521
Sjælland;2020-06-03;F;9;0;1;594;11709;2522
Syddanmark;2020-06-03;F;1;0;0;594;11710;2522
Hovedstaden;2020-06-03;M;9;0;0;594;11719;2522
Sjælland;2020-06-03;M;9;0;0;594;11728;2522
Hovedstaden;2020-06-04;F;18;0;1;594;11746;2523
Sjælland;2020-06-04;F;4;0;0;594;11750;2523
Syddanmark;2020-06-04;F;1;0;0;594;11751;2523
Hovedstaden;2020-06-04;M;8;1;1;595;11759;2524
Midtjylland;2020-06-04;M;5;0;0;595;11764;2524
Sjælland;2020-06-04;M;2;0;0;595;11766;2524
Syddanmark;2020-06-04;M;4;1;2;596;11770;2526
Hovedstaden;2020-06-05;F;14;0;2;596;11784;2528
Sjælland;2020-06-05;F;2;0;0;596;11786;2528
Hovedstaden;2020-06-05;M;15;0;1;596;11801;2529
Sjælland;2020-06-05;M;2;0;0;596;11803;2529
Syddanmark;2020-06-05;M;2;0;2;596;11805;2531
Hovedstaden;2020-06-06;F;7;0;1;596;11812;2532
Midtjylland;2020-06-06;F;1;0;0;596;11813;2532
Sjælland;2020-06-06;F;2;0;0;596;11815;2532
Hovedstaden;2020-06-06;M;4;0;0;596;11819;2532
Syddanmark;2020-06-06;M;1;0;0;596;11820;2532
Hovedstaden;2020-06-07;F;4;0;1;596;11824;2533
Hovedstaden;2020-06-07;M;10;0;1;596;11834;2534
Hovedstaden;2020-06-08;F;14;0;1;596;11848;2535
Midtjylland;2020-06-08;F;2;0;1;596;11850;2536
Nordjylland;2020-06-08;F;1;0;0;596;11851;2536
Sjælland;2020-06-08;F;1;0;0;596;11852;2536
Syddanmark;2020-06-08;F;3;0;0;596;11855;2536
Hovedstaden;2020-06-08;M;15;1;2;597;11870;2538
Midtjylland;2020-06-08;M;2;0;0;597;11872;2538
Sjælland;2020-06-08;M;1;0;0;597;11873;2538
Syddanmark;2020-06-08;M;5;0;0;597;11878;2538
Hovedstaden;2020-06-09;F;10;0;0;597;11888;2538
Midtjylland;2020-06-09;F;1;0;0;597;11889;2538
Sjælland;2020-06-09;F;3;0;0;597;11892;2538
Hovedstaden;2020-06-09;M;12;0;0;597;11904;2538
Midtjylland;2020-06-09;M;1;0;0;597;11905;2538
Sjælland;2020-06-09;M;1;0;0;597;11906;2538
Syddanmark;2020-06-09;M;3;0;0;597;11909;2538
Hovedstaden;2020-06-10;F;11;0;1;597;11920;2539
Midtjylland;2020-06-10;F;2;0;1;597;11922;2540
Nordjylland;2020-06-10;F;6;0;1;597;11928;2541
Sjælland;2020-06-10;F;3;0;1;597;11931;2542
Syddanmark;2020-06-10;F;1;0;0;597;11932;2542
Hovedstaden;2020-06-10;M;9;0;0;597;11941;2542
Nordjylland;2020-06-10;M;3;1;0;598;11944;2542
Sjælland;2020-06-10;M;4;0;0;598;11948;2542
Hovedstaden;2020-06-11;F;19;0;0;598;11967;2542
Midtjylland;2020-06-11;F;1;0;0;598;11968;2542
Nordjylland;2020-06-11;F;1;0;0;598;11969;2542
Sjælland;2020-06-11;F;6;0;0;598;11975;2542
Hovedstaden;2020-06-11;M;17;0;2;598;11992;2544
Nordjylland;2020-06-11;M;1;0;1;598;11993;2545
Sjælland;2020-06-11;M;3;0;0;598;11996;2545
Hovedstaden;2020-06-12;F;13;0;1;598;12009;2546
Midtjylland;2020-06-12;F;2;0;0;598;12011;2546
Nordjylland;2020-06-12;F;19;1;4;599;12030;2550
Sjælland;2020-06-12;F;2;1;1;600;12032;2551
Hovedstaden;2020-06-12;M;13;0;2;600;12045;2553
Midtjylland;2020-06-12;M;2;0;0;600;12047;2553
Nordjylland;2020-06-12;M;6;0;1;600;12053;2554
Sjælland;2020-06-12;M;2;0;1;600;12055;2555
Syddanmark;2020-06-12;M;1;0;0;600;12056;2555
Hovedstaden;2020-06-13;F;8;0;2;600;12064;2557
Midtjylland;2020-06-13;F;2;0;0;600;12066;2557
Sjælland;2020-06-13;F;3;0;1;600;12069;2558
Hovedstaden;2020-06-13;M;12;1;3;601;12081;2561
Sjælland;2020-06-13;M;3;0;1;601;12084;2562
Hovedstaden;2020-06-14;F;3;0;0;601;12087;2562
Midtjylland;2020-06-14;F;1;0;0;601;12088;2562
Nordjylland;2020-06-14;F;5;0;1;601;12093;2563
Hovedstaden;2020-06-14;M;7;0;2;601;12100;2565
Nordjylland;2020-06-14;M;3;1;1;602;12103;2566
Sjælland;2020-06-14;M;2;0;0;602;12105;2566
Hovedstaden;2020-06-15;F;15;1;3;603;12120;2569
Nordjylland;2020-06-15;F;2;0;0;603;12122;2569
Sjælland;2020-06-15;F;1;0;0;603;12123;2569
Hovedstaden;2020-06-15;M;17;1;3;604;12140;2572
Midtjylland;2020-06-15;M;1;0;1;604;12141;2573
Nordjylland;2020-06-15;M;1;0;0;604;12142;2573
Sjælland;2020-06-15;M;3;0;0;604;12145;2573
Hovedstaden;2020-06-16;F;15;0;0;604;12160;2573
Midtjylland;2020-06-16;F;4;0;1;604;12164;2574
Nordjylland;2020-06-16;F;3;0;1;604;12167;2575
Sjælland;2020-06-16;F;4;0;1;604;12171;2576
Hovedstaden;2020-06-16;M;10;0;2;604;12181;2578
Midtjylland;2020-06-16;M;1;0;0;604;12182;2578
Nordjylland;2020-06-16;M;4;0;0;604;12186;2578
Sjælland;2020-06-16;M;4;0;2;604;12190;2580
Syddanmark;2020-06-16;M;1;0;0;604;12191;2580
Hovedstaden;2020-06-17;F;21;0;1;604;12212;2581
Midtjylland;2020-06-17;F;1;0;0;604;12213;2581
Nordjylland;2020-06-17;F;14;0;2;604;12227;2583
Sjælland;2020-06-17;F;7;0;0;604;12234;2583
Syddanmark;2020-06-17;F;1;0;0;604;12235;2583
Hovedstaden;2020-06-17;M;20;0;1;604;12255;2584
Midtjylland;2020-06-17;M;2;0;0;604;12257;2584
Nordjylland;2020-06-17;M;2;0;1;604;12259;2585
Sjælland;2020-06-17;M;5;0;1;604;12264;2586
Syddanmark;2020-06-17;M;1;0;1;604;12265;2587
Hovedstaden;2020-06-18;F;18;1;1;605;12283;2588
Midtjylland;2020-06-18;F;1;0;0;605;12284;2588
Nordjylland;2020-06-18;F;1;0;0;605;12285;2588
Sjælland;2020-06-18;F;4;0;2;605;12289;2590
Hovedstaden;2020-06-18;M;19;0;1;605;12308;2591
Midtjylland;2020-06-18;M;1;1;1;606;12309;2592
Nordjylland;2020-06-18;M;1;0;0;606;12310;2592
Sjælland;2020-06-18;M;2;0;0;606;12312;2592
Syddanmark;2020-06-18;M;1;0;0;606;12313;2592
Hovedstaden;2020-06-19;F;15;0;2;606;12328;2594
Sjælland;2020-06-19;F;7;0;1;606;12335;2595
Hovedstaden;2020-06-19;M;9;0;0;606;12344;2595
Midtjylland;2020-06-19;M;2;0;0;606;12346;2595
Nordjylland;2020-06-19;M;1;0;0;606;12347;2595
Sjælland;2020-06-19;M;8;0;0;606;12355;2595
Hovedstaden;2020-06-20;F;19;0;0;606;12374;2595
Nordjylland;2020-06-20;F;2;0;0;606;12376;2595
Sjælland;2020-06-20;F;3;0;0;606;12379;2595
Hovedstaden;2020-06-20;M;12;0;0;606;12391;2595
Midtjylland;2020-06-20;M;2;0;0;606;12393;2595
Sjælland;2020-06-20;M;1;0;0;606;12394;2595
Hovedstaden;2020-06-21;F;16;0;0;606;12410;2595
Nordjylland;2020-06-21;F;1;0;1;606;12411;2596
Syddanmark;2020-06-21;F;2;0;0;606;12413;2596
Hovedstaden;2020-06-21;M;10;0;1;606;12423;2597
Midtjylland;2020-06-21;M;1;0;0;606;12424;2597
Nordjylland;2020-06-21;M;2;0;2;606;12426;2599
Sjælland;2020-06-21;M;1;0;0;606;12427;2599
Hovedstaden;2020-06-22;F;23;0;1;606;12450;2600
Nordjylland;2020-06-22;F;2;0;1;606;12452;2601
Sjælland;2020-06-22;F;2;1;1;607;12454;2602
Hovedstaden;2020-06-22;M;17;0;1;607;12471;2603
Midtjylland;2020-06-22;M;1;0;0;607;12472;2603
Nordjylland;2020-06-22;M;1;0;0;607;12473;2603
Sjælland;2020-06-22;M;1;0;1;607;12474;2604
Hovedstaden;2020-06-23;F;4;0;1;607;12478;2605
Midtjylland;2020-06-23;F;3;0;0;607;12481;2605
Nordjylland;2020-06-23;F;1;0;0;607;12482;2605
Syddanmark;2020-06-23;F;2;0;0;607;12484;2605
Hovedstaden;2020-06-23;M;4;0;0;607;12488;2605
Midtjylland;2020-06-23;M;1;0;0;607;12489;2605
Nordjylland;2020-06-23;M;3;0;1;607;12492;2606
Sjælland;2020-06-23;M;1;0;0;607;12493;2606
Hovedstaden;2020-06-24;F;9;0;2;607;12502;2608
Midtjylland;2020-06-24;F;2;0;0;607;12504;2608
Nordjylland;2020-06-24;F;7;0;1;607;12511;2609
Sjælland;2020-06-24;F;2;0;1;607;12513;2610
Syddanmark;2020-06-24;F;1;0;0;607;12514;2610
Hovedstaden;2020-06-24;M;6;0;1;607;12520;2611
Midtjylland;2020-06-24;M;1;0;0;607;12521;2611
Nordjylland;2020-06-24;M;10;0;4;607;12531;2615
Sjælland;2020-06-24;M;3;0;0;607;12534;2615
Syddanmark;2020-06-24;M;4;0;1;607;12538;2616
Hovedstaden;2020-06-25;F;12;0;0;607;12550;2616
Midtjylland;2020-06-25;F;3;0;0;607;12553;2616
Nordjylland;2020-06-25;F;2;0;0;607;12555;2616
Hovedstaden;2020-06-25;M;6;0;0;607;12561;2616
Midtjylland;2020-06-25;M;2;0;1;607;12563;2617
Nordjylland;2020-06-25;M;3;0;0;607;12566;2617
Sjælland;2020-06-25;M;1;0;1;607;12567;2618
Syddanmark;2020-06-25;M;1;0;0;607;12568;2618
Hovedstaden;2020-06-26;F;6;0;0;607;12574;2618
Midtjylland;2020-06-26;F;1;0;0;607;12575;2618
Nordjylland;2020-06-26;F;1;0;0;607;12576;2618
Syddanmark;2020-06-26;F;1;0;0;607;12577;2618
Hovedstaden;2020-06-26;M;7;0;2;607;12584;2620
Midtjylland;2020-06-26;M;2;0;0;607;12586;2620
Nordjylland;2020-06-26;M;1;0;0;607;12587;2620
Sjælland;2020-06-26;M;2;0;0;607;12589;2620
Hovedstaden;2020-06-27;F;2;0;0;607;12591;2620
Midtjylland;2020-06-27;F;1;0;1;607;12592;2621
Nordjylland;2020-06-27;F;4;0;1;607;12596;2622
Hovedstaden;2020-06-27;M;5;0;0;607;12601;2622
Midtjylland;2020-06-27;M;2;0;0;607;12603;2622
Nordjylland;2020-06-27;M;5;0;2;607;12608;2624
Hovedstaden;2020-06-28;F;3;0;0;607;12611;2624
Midtjylland;2020-06-28;F;2;0;0;607;12613;2624
Nordjylland;2020-06-28;F;1;0;0;607;12614;2624
Hovedstaden;2020-06-28;M;2;0;1;607;12616;2625
Midtjylland;2020-06-28;M;2;0;0;607;12618;2625
Syddanmark;2020-06-28;M;1;0;0;607;12619;2625
Hovedstaden;2020-06-29;F;11;0;0;607;12630;2625
Midtjylland;2020-06-29;F;1;0;0;607;12631;2625
Nordjylland;2020-06-29;F;1;0;0;607;12632;2625
Syddanmark;2020-06-29;F;2;0;0;607;12634;2625
Hovedstaden;2020-06-29;M;9;0;0;607;12643;2625
Nordjylland;2020-06-29;M;1;0;0;607;12644;2625
Sjælland;2020-06-29;M;2;0;0;607;12646;2625
Hovedstaden;2020-06-30;F;5;0;0;607;12651;2625
Midtjylland;2020-06-30;F;1;0;0;607;12652;2625
Nordjylland;2020-06-30;F;5;0;1;607;12657;2626
Sjælland;2020-06-30;F;3;0;0;607;12660;2626
Syddanmark;2020-06-30;F;1;0;0;607;12661;2626
Hovedstaden;2020-06-30;M;6;0;2;607;12667;2628
Midtjylland;2020-06-30;M;1;0;0;607;12668;2628
Nordjylland;2020-06-30;M;1;0;1;607;12669;2629
Sjælland;2020-06-30;M;2;0;0;607;12671;2629
Hovedstaden;2020-07-01;F;2;0;0;607;12673;2629
Nordjylland;2020-07-01;F;1;0;0;607;12674;2629
Hovedstaden;2020-07-01;M;4;0;1;607;12678;2630
Midtjylland;2020-07-01;M;2;0;0;607;12680;2630
Nordjylland;2020-07-01;M;1;0;0;607;12681;2630
Hovedstaden;2020-07-02;F;8;0;0;607;12689;2630
Midtjylland;2020-07-02;F;1;0;0;607;12690;2630
Hovedstaden;2020-07-02;M;6;1;1;608;12696;2631
Hovedstaden;2020-07-03;F;6;1;1;609;12702;2632
Nordjylland;2020-07-03;F;3;0;0;609;12705;2632
Hovedstaden;2020-07-03;M;6;0;0;609;12711;2632
Midtjylland;2020-07-03;M;1;0;0;609;12712;2632
Nordjylland;2020-07-03;M;2;0;0;609;12714;2632
Sjælland;2020-07-03;M;1;0;1;609;12715;2633
Hovedstaden;2020-07-04;F;2;0;0;609;12717;2633
Hovedstaden;2020-07-04;M;8;0;0;609;12725;2633
Midtjylland;2020-07-04;M;1;0;0;609;12726;2633
Nordjylland;2020-07-04;M;1;0;0;609;12727;2633
Syddanmark;2020-07-04;M;2;0;0;609;12729;2633
Hovedstaden;2020-07-05;F;8;1;2;610;12737;2635
Hovedstaden;2020-07-05;M;2;0;0;610;12739;2635
Midtjylland;2020-07-05;M;1;0;0;610;12740;2635
Nordjylland;2020-07-05;M;1;0;0;610;12741;2635
Syddanmark;2020-07-05;M;1;0;1;610;12742;2636
Hovedstaden;2020-07-06;F;2;0;1;610;12744;2637
Nordjylland;2020-07-06;F;1;0;0;610;12745;2637
Sjælland;2020-07-06;F;1;1;1;611;12746;2638
Hovedstaden;2020-07-06;M;4;0;0;611;12750;2638
Nordjylland;2020-07-06;M;1;0;0;611;12751;2638
Sjælland;2020-07-06;M;1;0;1;611;12752;2639
Syddanmark;2020-07-06;M;1;0;0;611;12753;2639
Hovedstaden;2020-07-07;F;1;0;0;611;12754;2639
Midtjylland;2020-07-07;F;1;0;0;611;12755;2639
Nordjylland;2020-07-07;F;1;0;0;611;12756;2639
Syddanmark;2020-07-07;F;1;0;0;611;12757;2639
Hovedstaden;2020-07-07;M;8;0;2;611;12765;2641
Nordjylland;2020-07-07;M;1;0;0;611;12766;2641
Hovedstaden;2020-07-08;F;10;0;1;611;12776;2642
Nordjylland;2020-07-08;F;3;0;1;611;12779;2643
Sjælland;2020-07-08;F;3;0;0;611;12782;2643
Hovedstaden;2020-07-08;M;9;0;0;611;12791;2643
Midtjylland;2020-07-08;M;1;0;0;611;12792;2643
Syddanmark;2020-07-08;M;1;0;1;611;12793;2644
Hovedstaden;2020-07-09;F;12;0;2;611;12805;2646
Midtjylland;2020-07-09;F;3;0;1;611;12808;2647
Nordjylland;2020-07-09;F;4;0;0;611;12812;2647
Sjælland;2020-07-09;F;5;0;1;611;12817;2648
Hovedstaden;2020-07-09;M;10;0;1;611;12827;2649
Midtjylland;2020-07-09;M;1;0;0;611;12828;2649
Nordjylland;2020-07-09;M;2;0;0;611;12830;2649
Sjælland;2020-07-09;M;4;0;0;611;12834;2649
Hovedstaden;2020-07-10;F;11;0;0;611;12845;2649
Nordjylland;2020-07-10;F;1;0;0;611;12846;2649
Sjælland;2020-07-10;F;1;0;0;611;12847;2649
Syddanmark;2020-07-10;F;1;0;0;611;12848;2649
Hovedstaden;2020-07-10;M;12;0;0;611;12860;2649
Nordjylland;2020-07-10;M;2;1;1;612;12862;2650
Sjælland;2020-07-10;M;3;0;0;612;12865;2650
Syddanmark;2020-07-10;M;2;0;0;612;12867;2650
Hovedstaden;2020-07-11;F;12;1;1;613;12879;2651
Sjælland;2020-07-11;F;1;0;0;613;12880;2651
Syddanmark;2020-07-11;F;2;0;0;613;12882;2651
Hovedstaden;2020-07-11;M;8;0;1;613;12890;2652
Sjælland;2020-07-11;M;1;0;0;613;12891;2652
Hovedstaden;2020-07-12;F;10;0;2;613;12901;2654
Nordjylland;2020-07-12;F;1;0;0;613;12902;2654
Sjælland;2020-07-12;F;1;0;0;613;12903;2654
Hovedstaden;2020-07-12;M;5;0;1;613;12908;2655
Midtjylland;2020-07-12;M;1;0;0;613;12909;2655
Nordjylland;2020-07-12;M;1;0;0;613;12910;2655
Sjælland;2020-07-12;M;4;0;0;613;12914;2655
Hovedstaden;2020-07-13;F;10;0;0;613;12924;2655
Midtjylland;2020-07-13;F;3;0;0;613;12927;2655
Sjælland;2020-07-13;F;8;0;4;613;12935;2659
Syddanmark;2020-07-13;F;1;0;0;613;12936;2659
Hovedstaden;2020-07-13;M;6;0;1;613;12942;2660
Midtjylland;2020-07-13;M;3;0;0;613;12945;2660
Sjælland;2020-07-13;M;2;0;0;613;12947;2660
Syddanmark;2020-07-13;M;1;0;0;613;12948;2660
Hovedstaden;2020-07-14;F;13;0;0;613;12961;2660
Midtjylland;2020-07-14;F;2;0;0;613;12963;2660
Sjælland;2020-07-14;F;2;0;0;613;12965;2660
Syddanmark;2020-07-14;F;2;0;0;613;12967;2660
Hovedstaden;2020-07-14;M;7;0;0;613;12974;2660
Midtjylland;2020-07-14;M;2;0;0;613;12976;2660
Nordjylland;2020-07-14;M;1;0;0;613;12977;2660
Sjælland;2020-07-14;M;3;0;0;613;12980;2660
Syddanmark;2020-07-14;M;2;0;0;613;12982;2660
Hovedstaden;2020-07-15;F;18;0;1;613;13000;2661
Midtjylland;2020-07-15;F;1;0;0;613;13001;2661
Nordjylland;2020-07-15;F;1;0;0;613;13002;2661
Sjælland;2020-07-15;F;2;0;0;613;13004;2661
Syddanmark;2020-07-15;F;1;0;0;613;13005;2661
Hovedstaden;2020-07-15;M;15;0;4;613;13020;2665
Midtjylland;2020-07-15;M;2;0;1;613;13022;2666
Nordjylland;2020-07-15;M;1;0;0;613;13023;2666
Sjælland;2020-07-15;M;2;0;1;613;13025;2667
Syddanmark;2020-07-15;M;1;0;0;613;13026;2667
Hovedstaden;2020-07-16;F;16;1;1;614;13042;2668
Midtjylland;2020-07-16;F;3;0;0;614;13045;2668
Sjælland;2020-07-16;F;3;0;0;614;13048;2668
Syddanmark;2020-07-16;F;4;0;0;614;13052;2668
Hovedstaden;2020-07-16;M;17;0;2;614;13069;2670
Midtjylland;2020-07-16;M;2;0;0;614;13071;2670
Sjælland;2020-07-16;M;6;0;0;614;13077;2670
Syddanmark;2020-07-16;M;1;0;0;614;13078;2670
Hovedstaden;2020-07-17;F;8;0;0;614;13086;2670
Midtjylland;2020-07-17;F;1;0;0;614;13087;2670
Nordjylland;2020-07-17;F;2;0;1;614;13089;2671
Sjælland;2020-07-17;F;5;0;0;614;13094;2671
Hovedstaden;2020-07-17;M;11;0;1;614;13105;2672
Nordjylland;2020-07-17;M;1;0;0;614;13106;2672
Sjælland;2020-07-17;M;5;0;0;614;13111;2672
Hovedstaden;2020-07-18;F;17;0;3;614;13128;2675
Sjælland;2020-07-18;F;7;0;0;614;13135;2675
Hovedstaden;2020-07-18;M;13;0;0;614;13148;2675
Sjælland;2020-07-18;M;6;0;1;614;13154;2676
Hovedstaden;2020-07-19;F;15;0;2;614;13169;2678
Nordjylland;2020-07-19;F;1;0;0;614;13170;2678
Sjælland;2020-07-19;F;3;0;0;614;13173;2678
Hovedstaden;2020-07-19;M;3;0;0;614;13176;2678
Midtjylland;2020-07-19;M;1;0;0;614;13177;2678
Nordjylland;2020-07-19;M;1;0;0;614;13178;2678
Sjælland;2020-07-19;M;4;0;1;614;13182;2679
Hovedstaden;2020-07-20;F;11;0;0;614;13193;2679
Midtjylland;2020-07-20;F;1;0;0;614;13194;2679
Sjælland;2020-07-20;F;4;0;0;614;13198;2679
Syddanmark;2020-07-20;F;1;0;0;614;13199;2679
Hovedstaden;2020-07-20;M;11;0;1;614;13210;2680
Midtjylland;2020-07-20;M;2;0;0;614;13212;2680
Sjælland;2020-07-20;M;3;0;0;614;13215;2680
Hovedstaden;2020-07-21;F;17;0;1;614;13232;2681
Nordjylland;2020-07-21;F;2;0;0;614;13234;2681
Sjælland;2020-07-21;F;3;0;0;614;13237;2681
Hovedstaden;2020-07-21;M;10;0;3;614;13247;2684
Midtjylland;2020-07-21;M;2;0;0;614;13249;2684
Nordjylland;2020-07-21;M;1;0;0;614;13250;2684
Sjælland;2020-07-21;M;1;0;0;614;13251;2684
Hovedstaden;2020-07-22;F;15;0;0;614;13266;2684
Nordjylland;2020-07-22;F;1;0;0;614;13267;2684
Sjælland;2020-07-22;F;2;0;0;614;13269;2684
Syddanmark;2020-07-22;F;1;0;0;614;13270;2684
Hovedstaden;2020-07-22;M;7;1;1;615;13277;2685
Nordjylland;2020-07-22;M;3;0;0;615;13280;2685
Sjælland;2020-07-22;M;5;0;0;615;13285;2685
Syddanmark;2020-07-22;M;1;0;1;615;13286;2686
Hovedstaden;2020-07-23;F;26;1;1;616;13312;2687
Midtjylland;2020-07-23;F;2;0;0;616;13314;2687
Nordjylland;2020-07-23;F;1;0;0;616;13315;2687
Sjælland;2020-07-23;F;2;0;0;616;13317;2687
Syddanmark;2020-07-23;F;4;0;0;616;13321;2687
Hovedstaden;2020-07-23;M;11;0;0;616;13332;2687
Nordjylland;2020-07-23;M;2;0;1;616;13334;2688
Sjælland;2020-07-23;M;3;0;1;616;13337;2689
Syddanmark;2020-07-23;M;1;0;0;616;13338;2689
Hovedstaden;2020-07-24;F;9;1;1;617;13347;2690
Midtjylland;2020-07-24;F;5;0;0;617;13352;2690
Sjælland;2020-07-24;F;1;0;0;617;13353;2690
Syddanmark;2020-07-24;F;2;0;1;617;13355;2691
Hovedstaden;2020-07-24;M;12;0;0;617;13367;2691
Midtjylland;2020-07-24;M;3;0;0;617;13370;2691
Nordjylland;2020-07-24;M;1;0;0;617;13371;2691
Sjælland;2020-07-24;M;1;0;0;617;13372;2691
Syddanmark;2020-07-24;M;2;0;1;617;13374;2692
Hovedstaden;2020-07-25;F;6;0;0;617;13380;2692
Midtjylland;2020-07-25;F;3;0;0;617;13383;2692
Sjælland;2020-07-25;F;5;0;0;617;13388;2692
Syddanmark;2020-07-25;F;2;0;0;617;13390;2692
Hovedstaden;2020-07-25;M;3;0;0;617;13393;2692
Midtjylland;2020-07-25;M;2;0;0;617;13395;2692
Nordjylland;2020-07-25;M;1;0;1;617;13396;2693
Sjælland;2020-07-25;M;4;1;2;618;13400;2695
Syddanmark;2020-07-25;M;1;0;0;618;13401;2695
Hovedstaden;2020-07-26;F;8;0;1;618;13409;2696
Midtjylland;2020-07-26;F;4;0;0;618;13413;2696
Nordjylland;2020-07-26;F;1;0;0;618;13414;2696
Sjælland;2020-07-26;F;2;0;1;618;13416;2697
Syddanmark;2020-07-26;F;3;0;0;618;13419;2697
Hovedstaden;2020-07-26;M;5;0;1;618;13424;2698
Syddanmark;2020-07-26;M;1;0;0;618;13425;2698
Hovedstaden;2020-07-27;F;9;0;1;618;13434;2699
Midtjylland;2020-07-27;F;3;0;0;618;13437;2699
Nordjylland;2020-07-27;F;1;0;0;618;13438;2699
Sjælland;2020-07-27;F;6;0;3;618;13444;2702
Syddanmark;2020-07-27;F;5;0;0;618;13449;2702
Hovedstaden;2020-07-27;M;14;0;0;618;13463;2702
Midtjylland;2020-07-27;M;3;0;0;618;13466;2702
Nordjylland;2020-07-27;M;1;0;0;618;13467;2702
Sjælland;2020-07-27;M;16;0;2;618;13483;2704
Syddanmark;2020-07-27;M;5;0;0;618;13488;2704
Hovedstaden;2020-07-28;F;6;0;0;618;13494;2704
Midtjylland;2020-07-28;F;8;0;1;618;13502;2705
Nordjylland;2020-07-28;F;2;0;0;618;13504;2705
Sjælland;2020-07-28;F;3;0;0;618;13507;2705
Syddanmark;2020-07-28;F;4;0;0;618;13511;2705
Hovedstaden;2020-07-28;M;24;0;0;618;13535;2705
Midtjylland;2020-07-28;M;4;0;0;618;13539;2705
Nordjylland;2020-07-28;M;2;0;0;618;13541;2705
Sjælland;2020-07-28;M;23;0;4;618;13564;2709
Syddanmark;2020-07-28;M;1;0;1;618;13565;2710
Hovedstaden;2020-07-29;F;9;0;2;618;13574;2712
Midtjylland;2020-07-29;F;4;0;1;618;13578;2713
Nordjylland;2020-07-29;F;1;0;1;618;13579;2714
Sjælland;2020-07-29;F;3;1;1;619;13582;2715
Syddanmark;2020-07-29;F;2;0;0;619;13584;2715
Hovedstaden;2020-07-29;M;14;0;1;619;13598;2716
Midtjylland;2020-07-29;M;6;0;2;619;13604;2718
Nordjylland;2020-07-29;M;4;0;0;619;13608;2718
Sjælland;2020-07-29;M;10;0;1;619;13618;2719
Syddanmark;2020-07-29;M;7;0;0;619;13625;2719
Hovedstaden;2020-07-30;F;12;0;0;619;13637;2719
Midtjylland;2020-07-30;F;14;0;0;619;13651;2719
Nordjylland;2020-07-30;F;2;0;0;619;13653;2719
Sjælland;2020-07-30;F;7;0;0;619;13660;2719
Syddanmark;2020-07-30;F;2;0;0;619;13662;2719
Hovedstaden;2020-07-30;M;14;0;1;619;13676;2720
Midtjylland;2020-07-30;M;7;0;1;619;13683;2721
Nordjylland;2020-07-30;M;2;0;0;619;13685;2721
Sjælland;2020-07-30;M;19;0;0;619;13704;2721
Syddanmark;2020-07-30;M;5;0;0;619;13709;2721
Hovedstaden;2020-07-31;F;9;0;0;619;13718;2721
Midtjylland;2020-07-31;F;5;0;0;619;13723;2721
Nordjylland;2020-07-31;F;2;0;0;619;13725;2721
Sjælland;2020-07-31;F;4;0;0;619;13729;2721
Syddanmark;2020-07-31;F;4;0;0;619;13733;2721
Hovedstaden;2020-07-31;M;4;0;0;619;13737;2721
Midtjylland;2020-07-31;M;13;0;2;619;13750;2723
Nordjylland;2020-07-31;M;1;0;0;619;13751;2723
Sjælland;2020-07-31;M;9;0;0;619;13760;2723
Syddanmark;2020-07-31;M;7;0;0;619;13767;2723
Hovedstaden;2020-08-01;F;4;0;0;619;13771;2723
Midtjylland;2020-08-01;F;7;1;1;620;13778;2724
Nordjylland;2020-08-01;F;1;0;0;620;13779;2724
Sjælland;2020-08-01;F;3;0;0;620;13782;2724
Syddanmark;2020-08-01;F;3;0;0;620;13785;2724
Hovedstaden;2020-08-01;M;7;0;0;620;13792;2724
Midtjylland;2020-08-01;M;23;0;0;620;13815;2724
Nordjylland;2020-08-01;M;3;0;0;620;13818;2724
Sjælland;2020-08-01;M;11;0;0;620;13829;2724
Syddanmark;2020-08-01;M;3;0;0;620;13832;2724
Hovedstaden;2020-08-02;F;12;0;0;620;13844;2724
Midtjylland;2020-08-02;F;14;0;0;620;13858;2724
Nordjylland;2020-08-02;F;2;0;0;620;13860;2724
Sjælland;2020-08-02;F;3;0;0;620;13863;2724
Syddanmark;2020-08-02;F;1;0;0;620;13864;2724
Hovedstaden;2020-08-02;M;9;0;0;620;13873;2724
Midtjylland;2020-08-02;M;25;0;2;620;13898;2726
Nordjylland;2020-08-02;M;4;0;0;620;13902;2726
Sjælland;2020-08-02;M;6;1;1;621;13908;2727
Syddanmark;2020-08-02;M;2;0;0;621;13910;2727
Hovedstaden;2020-08-03;F;9;0;0;621;13919;2727
Midtjylland;2020-08-03;F;24;0;1;621;13943;2728
Nordjylland;2020-08-03;F;3;0;0;621;13946;2728
Sjælland;2020-08-03;F;8;0;0;621;13954;2728
Syddanmark;2020-08-03;F;4;0;0;621;13958;2728
Hovedstaden;2020-08-03;M;12;0;0;621;13970;2728
Midtjylland;2020-08-03;M;29;0;2;621;13999;2730
Nordjylland;2020-08-03;M;2;0;0;621;14001;2730
Sjælland;2020-08-03;M;21;0;2;621;14022;2732
Syddanmark;2020-08-03;M;5;0;0;621;14027;2732
Hovedstaden;2020-08-04;F;14;0;0;621;14041;2732
Midtjylland;2020-08-04;F;21;0;0;621;14062;2732
Nordjylland;2020-08-04;F;3;0;0;621;14065;2732
Sjælland;2020-08-04;F;9;0;0;621;14074;2732
Syddanmark;2020-08-04;F;4;0;0;621;14078;2732
Hovedstaden;2020-08-04;M;11;0;1;621;14089;2733
Midtjylland;2020-08-04;M;38;0;1;621;14127;2734
Nordjylland;2020-08-04;M;1;0;0;621;14128;2734
Sjælland;2020-08-04;M;12;0;3;621;14140;2737
Syddanmark;2020-08-04;M;8;0;0;621;14148;2737
Hovedstaden;2020-08-05;F;14;0;0;621;14162;2737
Midtjylland;2020-08-05;F;25;0;2;621;14187;2739
Nordjylland;2020-08-05;F;2;0;0;621;14189;2739
Sjælland;2020-08-05;F;3;0;0;621;14192;2739
Syddanmark;2020-08-05;F;3;0;0;621;14195;2739
Hovedstaden;2020-08-05;M;15;0;1;621;14210;2740
Midtjylland;2020-08-05;M;41;0;2;621;14251;2742
Nordjylland;2020-08-05;M;2;0;0;621;14253;2742
Sjælland;2020-08-05;M;5;0;1;621;14258;2743
Syddanmark;2020-08-05;M;6;0;0;621;14264;2743
Hovedstaden;2020-08-06;F;13;0;2;621;14277;2745
Midtjylland;2020-08-06;F;37;0;1;621;14314;2746
Nordjylland;2020-08-06;F;3;0;0;621;14317;2746
Sjælland;2020-08-06;F;5;0;0;621;14322;2746
Syddanmark;2020-08-06;F;7;0;1;621;14329;2747
Hovedstaden;2020-08-06;M;22;0;2;621;14351;2749
Midtjylland;2020-08-06;M;50;0;2;621;14401;2751
Nordjylland;2020-08-06;M;1;0;0;621;14402;2751
Sjælland;2020-08-06;M;27;0;0;621;14429;2751
Syddanmark;2020-08-06;M;7;0;0;621;14436;2751
Hovedstaden;2020-08-07;F;13;0;1;621;14449;2752
Midtjylland;2020-08-07;F;46;0;2;621;14495;2754
Nordjylland;2020-08-07;F;2;0;0;621;14497;2754
Sjælland;2020-08-07;F;4;0;0;621;14501;2754
Syddanmark;2020-08-07;F;2;0;0;621;14503;2754
Hovedstaden;2020-08-07;M;7;0;0;621;14510;2754
Midtjylland;2020-08-07;M;60;0;0;621;14570;2754
Nordjylland;2020-08-07;M;2;0;0;621;14572;2754
Sjælland;2020-08-07;M;3;0;0;621;14575;2754
Syddanmark;2020-08-07;M;2;0;0;621;14577;2754
Hovedstaden;2020-08-08;F;11;0;0;621;14588;2754
Midtjylland;2020-08-08;F;26;1;2;622;14614;2756
Nordjylland;2020-08-08;F;1;0;0;622;14615;2756
Sjælland;2020-08-08;F;5;0;0;622;14620;2756
Syddanmark;2020-08-08;F;1;0;0;622;14621;2756
Hovedstaden;2020-08-08;M;8;0;0;622;14629;2756
Midtjylland;2020-08-08;M;31;0;1;622;14660;2757
Nordjylland;2020-08-08;M;1;0;0;622;14661;2757
Sjælland;2020-08-08;M;3;0;1;622;14664;2758
Syddanmark;2020-08-08;M;2;0;0;622;14666;2758
Hovedstaden;2020-08-09;F;14;0;0;622;14680;2758
Midtjylland;2020-08-09;F;32;0;0;622;14712;2758
Nordjylland;2020-08-09;F;5;0;0;622;14717;2758
Sjælland;2020-08-09;F;2;0;0;622;14719;2758
Syddanmark;2020-08-09;F;6;0;0;622;14725;2758
Hovedstaden;2020-08-09;M;28;0;1;622;14753;2759
Midtjylland;2020-08-09;M;33;0;1;622;14786;2760
Nordjylland;2020-08-09;M;4;0;0;622;14790;2760
Sjælland;2020-08-09;M;2;0;0;622;14792;2760
Syddanmark;2020-08-09;M;4;0;0;622;14796;2760
Hovedstaden;2020-08-10;F;18;0;0;622;14814;2760
Midtjylland;2020-08-10;F;37;0;0;622;14851;2760
Nordjylland;2020-08-10;F;2;0;0;622;14853;2760
Sjælland;2020-08-10;F;6;0;1;622;14859;2761
Syddanmark;2020-08-10;F;3;0;0;622;14862;2761
Hovedstaden;2020-08-10;M;27;0;1;622;14889;2762
Midtjylland;2020-08-10;M;43;0;1;622;14932;2763
Nordjylland;2020-08-10;M;5;0;0;622;14937;2763
Sjælland;2020-08-10;M;4;0;0;622;14941;2763
Syddanmark;2020-08-10;M;9;0;0;622;14950;2763
Hovedstaden;2020-08-11;F;19;0;1;622;14969;2764
Midtjylland;2020-08-11;F;26;0;1;622;14995;2765
Nordjylland;2020-08-11;F;2;0;0;622;14997;2765
Sjælland;2020-08-11;F;7;0;0;622;15004;2765
Syddanmark;2020-08-11;F;5;0;0;622;15009;2765
Hovedstaden;2020-08-11;M;22;0;1;622;15031;2766
Midtjylland;2020-08-11;M;41;0;1;622;15072;2767
Sjælland;2020-08-11;M;11;0;2;622;15083;2769
Syddanmark;2020-08-11;M;4;0;0;622;15087;2769
Hovedstaden;2020-08-12;F;22;0;4;622;15109;2773
Midtjylland;2020-08-12;F;33;0;2;622;15142;2775
Nordjylland;2020-08-12;F;9;0;0;622;15151;2775
Sjælland;2020-08-12;F;1;0;0;622;15152;2775
Syddanmark;2020-08-12;F;3;0;0;622;15155;2775
Hovedstaden;2020-08-12;M;27;0;0;622;15182;2775
Midtjylland;2020-08-12;M;48;0;0;622;15230;2775
Nordjylland;2020-08-12;M;10;0;2;622;15240;2777
Sjælland;2020-08-12;M;4;0;1;622;15244;2778
Syddanmark;2020-08-12;M;5;0;0;622;15249;2778
Hovedstaden;2020-08-13;F;15;0;0;622;15264;2778
Midtjylland;2020-08-13;F;30;0;0;622;15294;2778
Nordjylland;2020-08-13;F;3;0;1;622;15297;2779
Sjælland;2020-08-13;F;1;0;0;622;15298;2779
Syddanmark;2020-08-13;F;4;0;0;622;15302;2779
Hovedstaden;2020-08-13;M;20;0;0;622;15322;2779
Midtjylland;2020-08-13;M;30;0;0;622;15352;2779
Nordjylland;2020-08-13;M;5;1;1;623;15357;2780
Sjælland;2020-08-13;M;1;0;0;623;15358;2780
Syddanmark;2020-08-13;M;8;0;0;623;15366;2780
Hovedstaden;2020-08-14;F;26;0;0;623;15392;2780
Midtjylland;2020-08-14;F;14;0;0;623;15406;2780
Nordjylland;2020-08-14;F;5;0;0;623;15411;2780
Sjælland;2020-08-14;F;3;0;0;623;15414;2780
Syddanmark;2020-08-14;F;3;0;0;623;15417;2780
Hovedstaden;2020-08-14;M;23;1;2;624;15440;2782
Midtjylland;2020-08-14;M;16;0;1;624;15456;2783
Nordjylland;2020-08-14;M;3;0;0;624;15459;2783
Sjælland;2020-08-14;M;11;0;0;624;15470;2783
Syddanmark;2020-08-14;M;7;0;0;624;15477;2783
Hovedstaden;2020-08-15;F;12;0;0;624;15489;2783
Midtjylland;2020-08-15;F;46;0;3;624;15535;2786
Nordjylland;2020-08-15;F;5;0;0;624;15540;2786
Sjælland;2020-08-15;F;4;0;1;624;15544;2787
Syddanmark;2020-08-15;F;8;0;1;624;15552;2788
Hovedstaden;2020-08-15;M;13;0;0;624;15565;2788
Midtjylland;2020-08-15;M;33;0;0;624;15598;2788
Nordjylland;2020-08-15;M;1;0;0;624;15599;2788
Sjælland;2020-08-15;M;2;0;0;624;15601;2788
Syddanmark;2020-08-15;M;3;0;0;624;15604;2788
Hovedstaden;2020-08-16;F;15;0;0;624;15619;2788
Midtjylland;2020-08-16;F;17;0;1;624;15636;2789
Nordjylland;2020-08-16;F;4;0;0;624;15640;2789
Sjælland;2020-08-16;F;4;0;0;624;15644;2789
Syddanmark;2020-08-16;F;4;0;0;624;15648;2789
Hovedstaden;2020-08-16;M;15;0;1;624;15663;2790
Midtjylland;2020-08-16;M;15;0;0;624;15678;2790
Nordjylland;2020-08-16;M;6;1;1;625;15684;2791
Sjælland;2020-08-16;M;3;0;0;625;15687;2791
Syddanmark;2020-08-16;M;7;0;0;625;15694;2791
Hovedstaden;2020-08-17;F;10;0;1;625;15704;2792
Midtjylland;2020-08-17;F;26;0;0;625;15730;2792
Nordjylland;2020-08-17;F;4;0;0;625;15734;2792
Sjælland;2020-08-17;F;3;0;1;625;15737;2793
Syddanmark;2020-08-17;F;5;0;0;625;15742;2793
Hovedstaden;2020-08-17;M;20;0;0;625;15762;2793
Midtjylland;2020-08-17;M;17;0;1;625;15779;2794
Nordjylland;2020-08-17;M;4;0;0;625;15783;2794
Sjælland;2020-08-17;M;3;0;0;625;15786;2794
Syddanmark;2020-08-17;M;5;0;0;625;15791;2794
Hovedstaden;2020-08-18;F;16;1;2;626;15807;2796
Midtjylland;2020-08-18;F;19;0;0;626;15826;2796
Nordjylland;2020-08-18;F;4;0;0;626;15830;2796
Sjælland;2020-08-18;F;8;0;1;626;15838;2797
Syddanmark;2020-08-18;F;4;0;0;626;15842;2797
Hovedstaden;2020-08-18;M;24;0;0;626;15866;2797
Midtjylland;2020-08-18;M;22;0;0;626;15888;2797
Nordjylland;2020-08-18;M;3;1;1;627;15891;2798
Sjælland;2020-08-18;M;6;0;0;627;15897;2798
Syddanmark;2020-08-18;M;6;0;0;627;15903;2798
Hovedstaden;2020-08-19;F;11;0;1;627;15914;2799
Midtjylland;2020-08-19;F;12;0;0;627;15926;2799
Nordjylland;2020-08-19;F;6;0;0;627;15932;2799
Sjælland;2020-08-19;F;1;0;0;627;15933;2799
Syddanmark;2020-08-19;F;7;1;1;628;15940;2800
Hovedstaden;2020-08-19;M;23;0;1;628;15963;2801
Midtjylland;2020-08-19;M;15;0;1;628;15978;2802
Nordjylland;2020-08-19;M;2;0;0;628;15980;2802
Sjælland;2020-08-19;M;3;0;0;628;15983;2802
Syddanmark;2020-08-19;M;6;0;0;628;15989;2802
Hovedstaden;2020-08-20;F;10;0;1;628;15999;2803
Midtjylland;2020-08-20;F;15;0;1;628;16014;2804
Nordjylland;2020-08-20;F;1;0;0;628;16015;2804
Sjælland;2020-08-20;F;4;0;0;628;16019;2804
Syddanmark;2020-08-20;F;4;0;0;628;16023;2804
Hovedstaden;2020-08-20;M;15;0;1;628;16038;2805
Midtjylland;2020-08-20;M;16;0;1;628;16054;2806
Nordjylland;2020-08-20;M;3;0;0;628;16057;2806
Sjælland;2020-08-20;M;7;0;1;628;16064;2807
Syddanmark;2020-08-20;M;7;0;0;628;16071;2807
Hovedstaden;2020-08-21;F;6;0;0;628;16077;2807
Midtjylland;2020-08-21;F;14;0;1;628;16091;2808
Nordjylland;2020-08-21;F;4;0;1;628;16095;2809
Sjælland;2020-08-21;F;3;0;0;628;16098;2809
Syddanmark;2020-08-21;F;5;0;0;628;16103;2809
Hovedstaden;2020-08-21;M;23;0;0;628;16126;2809
Midtjylland;2020-08-21;M;13;0;0;628;16139;2809
Nordjylland;2020-08-21;M;3;0;0;628;16142;2809
Sjælland;2020-08-21;M;2;0;0;628;16144;2809
Syddanmark;2020-08-21;M;10;0;0;628;16154;2809
Hovedstaden;2020-08-22;F;18;0;0;628;16172;2809
Midtjylland;2020-08-22;F;17;0;0;628;16189;2809
Nordjylland;2020-08-22;F;4;0;0;628;16193;2809
Sjælland;2020-08-22;F;2;0;0;628;16195;2809
Syddanmark;2020-08-22;F;11;0;1;628;16206;2810
Hovedstaden;2020-08-22;M;11;0;0;628;16217;2810
Midtjylland;2020-08-22;M;12;0;0;628;16229;2810
Nordjylland;2020-08-22;M;2;0;1;628;16231;2811
Sjælland;2020-08-22;M;3;0;2;628;16234;2813
Syddanmark;2020-08-22;M;8;0;1;628;16242;2814
Hovedstaden;2020-08-23;F;11;0;0;628;16253;2814
Midtjylland;2020-08-23;F;13;0;0;628;16266;2814
Nordjylland;2020-08-23;F;6;0;0;628;16272;2814
Sjælland;2020-08-23;F;1;0;0;628;16273;2814
Syddanmark;2020-08-23;F;7;0;0;628;16280;2814
Hovedstaden;2020-08-23;M;12;0;1;628;16292;2815
Midtjylland;2020-08-23;M;10;0;0;628;16302;2815
Nordjylland;2020-08-23;M;2;1;1;629;16304;2816
Sjælland;2020-08-23;M;3;0;0;629;16307;2816
Syddanmark;2020-08-23;M;8;0;0;629;16315;2816
Hovedstaden;2020-08-24;F;11;0;1;629;16326;2817
Midtjylland;2020-08-24;F;15;0;0;629;16341;2817
Nordjylland;2020-08-24;F;3;0;0;629;16344;2817
Sjælland;2020-08-24;F;2;0;0;629;16346;2817
Syddanmark;2020-08-24;F;4;0;0;629;16350;2817
Hovedstaden;2020-08-24;M;14;0;2;629;16364;2819
Midtjylland;2020-08-24;M;14;0;2;629;16378;2821
Nordjylland;2020-08-24;M;3;0;0;629;16381;2821
Sjælland;2020-08-24;M;4;0;0;629;16385;2821
Syddanmark;2020-08-24;M;2;0;0;629;16387;2821
Hovedstaden;2020-08-25;F;13;0;1;629;16400;2822
Midtjylland;2020-08-25;F;10;0;0;629;16410;2822
Nordjylland;2020-08-25;F;4;0;0;629;16414;2822
Sjælland;2020-08-25;F;3;0;0;629;16417;2822
Syddanmark;2020-08-25;F;6;0;0;629;16423;2822
Hovedstaden;2020-08-25;M;25;0;1;629;16448;2823
Midtjylland;2020-08-25;M;12;0;1;629;16460;2824
Nordjylland;2020-08-25;M;5;0;0;629;16465;2824
Sjælland;2020-08-25;M;1;0;0;629;16466;2824
Syddanmark;2020-08-25;M;4;0;0;629;16470;2824
Hovedstaden;2020-08-26;F;20;0;1;629;16490;2825
Midtjylland;2020-08-26;F;9;0;0;629;16499;2825
Nordjylland;2020-08-26;F;1;0;0;629;16500;2825
Sjælland;2020-08-26;F;4;0;0;629;16504;2825
Syddanmark;2020-08-26;F;4;0;0;629;16508;2825
Hovedstaden;2020-08-26;M;16;0;0;629;16524;2825
Midtjylland;2020-08-26;M;11;0;0;629;16535;2825
Nordjylland;2020-08-26;M;3;0;1;629;16538;2826
Sjælland;2020-08-26;M;6;0;2;629;16544;2828
Syddanmark;2020-08-26;M;6;0;0;629;16550;2828
Hovedstaden;2020-08-27;F;7;0;0;629;16557;2828
Midtjylland;2020-08-27;F;10;0;0;629;16567;2828
Nordjylland;2020-08-27;F;1;0;0;629;16568;2828
Sjælland;2020-08-27;F;2;0;0;629;16570;2828
Syddanmark;2020-08-27;F;6;0;1;629;16576;2829
Hovedstaden;2020-08-27;M;16;0;1;629;16592;2830
Midtjylland;2020-08-27;M;10;0;0;629;16602;2830
Nordjylland;2020-08-27;M;3;0;0;629;16605;2830
Sjælland;2020-08-27;M;5;0;0;629;16610;2830
Syddanmark;2020-08-27;M;9;0;0;629;16619;2830
Hovedstaden;2020-08-28;F;18;0;0;629;16637;2830
Midtjylland;2020-08-28;F;13;0;1;629;16650;2831
Nordjylland;2020-08-28;F;4;0;1;629;16654;2832
Sjælland;2020-08-28;F;4;0;1;629;16658;2833
Syddanmark;2020-08-28;F;7;0;0;629;16665;2833
Hovedstaden;2020-08-28;M;24;0;1;629;16689;2834
Midtjylland;2020-08-28;M;12;0;0;629;16701;2834
Nordjylland;2020-08-28;M;5;0;1;629;16706;2835
Sjælland;2020-08-28;M;5;0;0;629;16711;2835
Syddanmark;2020-08-28;M;15;0;0;629;16726;2835
Hovedstaden;2020-08-29;F;16;0;2;629;16742;2837
Midtjylland;2020-08-29;F;6;0;0;629;16748;2837
Nordjylland;2020-08-29;F;5;0;0;629;16753;2837
Sjælland;2020-08-29;F;1;0;0;629;16754;2837
Syddanmark;2020-08-29;F;10;0;0;629;16764;2837
Hovedstaden;2020-08-29;M;22;0;2;629;16786;2839
Midtjylland;2020-08-29;M;12;0;1;629;16798;2840
Nordjylland;2020-08-29;M;6;0;0;629;16804;2840
Sjælland;2020-08-29;M;1;0;0;629;16805;2840
Syddanmark;2020-08-29;M;4;0;0;629;16809;2840
Hovedstaden;2020-08-30;F;23;0;4;629;16832;2844
Midtjylland;2020-08-30;F;11;0;1;629;16843;2845
Nordjylland;2020-08-30;F;3;0;0;629;16846;2845
Sjælland;2020-08-30;F;1;0;0;629;16847;2845
Syddanmark;2020-08-30;F;11;0;1;629;16858;2846
Hovedstaden;2020-08-30;M;28;0;2;629;16886;2848
Midtjylland;2020-08-30;M;12;0;0;629;16898;2848
Nordjylland;2020-08-30;M;3;0;0;629;16901;2848
Sjælland;2020-08-30;M;4;0;0;629;16905;2848
Syddanmark;2020-08-30;M;8;0;0;629;16913;2848
Hovedstaden;2020-08-31;F;31;0;0;629;16944;2848
Midtjylland;2020-08-31;F;11;0;0;629;16955;2848
Sjælland;2020-08-31;F;2;0;0;629;16957;2848
Syddanmark;2020-08-31;F;14;0;2;629;16971;2850
Hovedstaden;2020-08-31;M;36;0;0;629;17007;2850
Midtjylland;2020-08-31;M;8;0;1;629;17015;2851
Nordjylland;2020-08-31;M;3;0;0;629;17018;2851
Sjælland;2020-08-31;M;7;0;0;629;17025;2851
Syddanmark;2020-08-31;M;8;0;1;629;17033;2852
Hovedstaden;2020-09-01;F;39;0;1;629;17072;2853
Midtjylland;2020-09-01;F;19;0;0;629;17091;2853
Nordjylland;2020-09-01;F;3;0;0;629;17094;2853
Sjælland;2020-09-01;F;6;0;0;629;17100;2853
Syddanmark;2020-09-01;F;26;0;1;629;17126;2854
Hovedstaden;2020-09-01;M;52;0;1;629;17178;2855
Midtjylland;2020-09-01;M;14;0;0;629;17192;2855
Nordjylland;2020-09-01;M;4;0;0;629;17196;2855
Sjælland;2020-09-01;M;10;0;0;629;17206;2855
Syddanmark;2020-09-01;M;25;0;2;629;17231;2857
Hovedstaden;2020-09-02;F;37;0;3;629;17268;2860
Midtjylland;2020-09-02;F;6;0;0;629;17274;2860
Nordjylland;2020-09-02;F;3;0;0;629;17277;2860
Sjælland;2020-09-02;F;5;0;0;629;17282;2860
Syddanmark;2020-09-02;F;18;0;0;629;17300;2860
Hovedstaden;2020-09-02;M;48;0;8;629;17348;2868
Midtjylland;2020-09-02;M;11;0;1;629;17359;2869
Nordjylland;2020-09-02;M;1;0;0;629;17360;2869
Sjælland;2020-09-02;M;9;0;0;629;17369;2869
Syddanmark;2020-09-02;M;18;0;1;629;17387;2870
Hovedstaden;2020-09-03;F;53;0;3;629;17440;2873
Midtjylland;2020-09-03;F;10;0;1;629;17450;2874
Nordjylland;2020-09-03;F;4;0;0;629;17454;2874
Sjælland;2020-09-03;F;6;0;0;629;17460;2874
Syddanmark;2020-09-03;F;20;0;0;629;17480;2874
Hovedstaden;2020-09-03;M;62;0;3;629;17542;2877
Midtjylland;2020-09-03;M;6;0;1;629;17548;2878
Nordjylland;2020-09-03;M;7;0;0;629;17555;2878
Sjælland;2020-09-03;M;9;0;1;629;17564;2879
Syddanmark;2020-09-03;M;15;0;0;629;17579;2879
Hovedstaden;2020-09-04;F;68;1;3;630;17647;2882
Midtjylland;2020-09-04;F;10;0;0;630;17657;2882
Nordjylland;2020-09-04;F;8;0;0;630;17665;2882
Sjælland;2020-09-04;F;8;0;1;630;17673;2883
Syddanmark;2020-09-04;F;12;0;0;630;17685;2883
Hovedstaden;2020-09-04;M;46;1;1;631;17731;2884
Midtjylland;2020-09-04;M;11;0;2;631;17742;2886
Nordjylland;2020-09-04;M;7;0;1;631;17749;2887
Sjælland;2020-09-04;M;15;0;1;631;17764;2888
Syddanmark;2020-09-04;M;14;0;0;631;17778;2888
Hovedstaden;2020-09-05;F;49;0;3;631;17827;2891
Midtjylland;2020-09-05;F;8;0;0;631;17835;2891
Nordjylland;2020-09-05;F;4;0;2;631;17839;2893
Sjælland;2020-09-05;F;5;0;0;631;17844;2893
Syddanmark;2020-09-05;F;25;0;0;631;17869;2893
Hovedstaden;2020-09-05;M;55;1;2;632;17924;2895
Midtjylland;2020-09-05;M;6;0;1;632;17930;2896
Nordjylland;2020-09-05;M;8;0;0;632;17938;2896
Sjælland;2020-09-05;M;12;0;0;632;17950;2896
Syddanmark;2020-09-05;M;27;0;2;632;17977;2898
Hovedstaden;2020-09-06;F;89;1;2;633;18066;2900
Midtjylland;2020-09-06;F;13;0;1;633;18079;2901
Nordjylland;2020-09-06;F;7;0;0;633;18086;2901
Sjælland;2020-09-06;F;9;0;1;633;18095;2902
Syddanmark;2020-09-06;F;9;0;0;633;18104;2902
Hovedstaden;2020-09-06;M;62;0;3;633;18166;2905
Midtjylland;2020-09-06;M;5;0;1;633;18171;2906
Nordjylland;2020-09-06;M;9;0;1;633;18180;2907
Sjælland;2020-09-06;M;9;0;0;633;18189;2907
Syddanmark;2020-09-06;M;10;0;0;633;18199;2907
Hovedstaden;2020-09-07;F;79;0;3;633;18278;2910
Midtjylland;2020-09-07;F;14;0;2;633;18292;2912
Nordjylland;2020-09-07;F;16;0;2;633;18308;2914
Sjælland;2020-09-07;F;41;0;2;633;18349;2916
Syddanmark;2020-09-07;F;13;0;0;633;18362;2916
Hovedstaden;2020-09-07;M;79;1;3;634;18441;2919
Midtjylland;2020-09-07;M;6;0;0;634;18447;2919
Nordjylland;2020-09-07;M;11;0;0;634;18458;2919
Sjælland;2020-09-07;M;25;0;1;634;18483;2920
Syddanmark;2020-09-07;M;11;0;0;634;18494;2920
Hovedstaden;2020-09-08;F;75;0;3;634;18569;2923
Midtjylland;2020-09-08;F;26;0;3;634;18595;2926
Nordjylland;2020-09-08;F;11;0;1;634;18606;2927
Sjælland;2020-09-08;F;25;0;1;634;18631;2928
Syddanmark;2020-09-08;F;32;0;0;634;18663;2928
Hovedstaden;2020-09-08;M;82;0;2;634;18745;2930
Midtjylland;2020-09-08;M;15;0;0;634;18760;2930
Nordjylland;2020-09-08;M;13;1;1;635;18773;2931
Sjælland;2020-09-08;M;25;0;1;635;18798;2932
Syddanmark;2020-09-08;M;23;1;2;636;18821;2934
Hovedstaden;2020-09-09;F;67;0;3;636;18888;2937
Midtjylland;2020-09-09;F;16;0;1;636;18904;2938
Nordjylland;2020-09-09;F;14;0;0;636;18918;2938
Sjælland;2020-09-09;F;7;0;0;636;18925;2938
Syddanmark;2020-09-09;F;30;0;0;636;18955;2938
Hovedstaden;2020-09-09;M;90;1;5;637;19045;2943
Midtjylland;2020-09-09;M;12;0;1;637;19057;2944
Nordjylland;2020-09-09;M;15;0;0;637;19072;2944
Sjælland;2020-09-09;M;17;0;1;637;19089;2945
Syddanmark;2020-09-09;M;25;0;2;637;19114;2947
Hovedstaden;2020-09-10;F;101;2;5;639;19215;2952
Midtjylland;2020-09-10;F;8;0;0;639;19223;2952
Nordjylland;2020-09-10;F;18;0;0;639;19241;2952
Sjælland;2020-09-10;F;30;0;1;639;19271;2953
Syddanmark;2020-09-10;F;35;0;1;639;19306;2954
Hovedstaden;2020-09-10;M;96;2;8;641;19402;2962
Midtjylland;2020-09-10;M;20;0;0;641;19422;2962
Nordjylland;2020-09-10;M;19;1;1;642;19441;2963
Sjælland;2020-09-10;M;20;0;0;642;19461;2963
Syddanmark;2020-09-10;M;20;0;2;642;19481;2965
Hovedstaden;2020-09-11;F;93;1;3;643;19574;2968
Midtjylland;2020-09-11;F;28;0;0;643;19602;2968
Nordjylland;2020-09-11;F;21;0;1;643;19623;2969
Sjælland;2020-09-11;F;10;0;0;643;19633;2969
Syddanmark;2020-09-11;F;21;0;0;643;19654;2969
Hovedstaden;2020-09-11;M;76;0;4;643;19730;2973
Midtjylland;2020-09-11;M;43;0;5;643;19773;2978
Nordjylland;2020-09-11;M;22;0;0;643;19795;2978
Sjælland;2020-09-11;M;11;0;0;643;19806;2978
Syddanmark;2020-09-11;M;21;0;1;643;19827;2979
Hovedstaden;2020-09-12;F;89;0;3;643;19916;2982
Midtjylland;2020-09-12;F;14;0;1;643;19930;2983
Nordjylland;2020-09-12;F;12;0;0;643;19942;2983
Sjælland;2020-09-12;F;11;0;0;643;19953;2983
Syddanmark;2020-09-12;F;20;0;0;643;19973;2983
Hovedstaden;2020-09-12;M;85;2;4;645;20058;2987
Midtjylland;2020-09-12;M;15;0;1;645;20073;2988
Nordjylland;2020-09-12;M;19;1;1;646;20092;2989
Sjælland;2020-09-12;M;12;0;0;646;20104;2989
Syddanmark;2020-09-12;M;24;0;1;646;20128;2990
Hovedstaden;2020-09-13;F;83;0;6;646;20211;2996
Midtjylland;2020-09-13;F;7;0;0;646;20218;2996
Nordjylland;2020-09-13;F;19;0;0;646;20237;2996
Sjælland;2020-09-13;F;8;1;1;647;20245;2997
Syddanmark;2020-09-13;F;20;0;1;647;20265;2998
Hovedstaden;2020-09-13;M;88;1;4;648;20353;3002
Midtjylland;2020-09-13;M;9;0;0;648;20362;3002
Nordjylland;2020-09-13;M;23;0;3;648;20385;3005
Sjælland;2020-09-13;M;9;0;1;648;20394;3006
Syddanmark;2020-09-13;M;32;1;1;649;20426;3007
Hovedstaden;2020-09-14;F;115;0;3;649;20541;3010
Midtjylland;2020-09-14;F;18;0;0;649;20559;3010
Nordjylland;2020-09-14;F;19;0;1;649;20578;3011
Sjælland;2020-09-14;F;16;0;2;649;20594;3013
Syddanmark;2020-09-14;F;20;0;1;649;20614;3014
Hovedstaden;2020-09-14;M;108;0;5;649;20722;3019
Midtjylland;2020-09-14;M;18;0;1;649;20740;3020
Nordjylland;2020-09-14;M;29;1;3;650;20769;3023
Sjælland;2020-09-14;M;15;0;0;650;20784;3023
Syddanmark;2020-09-14;M;23;0;1;650;20807;3024
Hovedstaden;2020-09-15;F;136;0;7;650;20943;3031
Midtjylland;2020-09-15;F;22;0;3;650;20965;3034
Nordjylland;2020-09-15;F;32;0;2;650;20997;3036
Sjælland;2020-09-15;F;17;0;0;650;21014;3036
Syddanmark;2020-09-15;F;29;0;1;650;21043;3037
Hovedstaden;2020-09-15;M;104;0;4;650;21147;3041
Midtjylland;2020-09-15;M;25;0;3;650;21172;3044
Nordjylland;2020-09-15;M;29;0;1;650;21201;3045
Sjælland;2020-09-15;M;20;0;3;650;21221;3048
Syddanmark;2020-09-15;M;21;0;0;650;21242;3048
Hovedstaden;2020-09-16;F;151;2;12;652;21393;3060
Midtjylland;2020-09-16;F;29;0;2;652;21422;3062
Nordjylland;2020-09-16;F;38;0;0;652;21460;3062
Sjælland;2020-09-16;F;31;0;0;652;21491;3062
Syddanmark;2020-09-16;F;33;0;0;652;21524;3062
Hovedstaden;2020-09-16;M;157;1;7;653;21681;3069
Midtjylland;2020-09-16;M;34;0;2;653;21715;3071
Nordjylland;2020-09-16;M;28;1;2;654;21743;3073
Sjælland;2020-09-16;M;16;0;2;654;21759;3075
Syddanmark;2020-09-16;M;35;0;2;654;21794;3077
Hovedstaden;2020-09-17;F;144;1;5;655;21938;3082
Midtjylland;2020-09-17;F;32;0;1;655;21970;3083
Nordjylland;2020-09-17;F;13;0;1;655;21983;3084
Sjælland;2020-09-17;F;23;0;1;655;22006;3085
Syddanmark;2020-09-17;F;27;0;0;655;22033;3085
Hovedstaden;2020-09-17;M;170;0;5;655;22203;3090
Midtjylland;2020-09-17;M;29;0;0;655;22232;3090
Nordjylland;2020-09-17;M;24;1;4;656;22256;3094
Sjælland;2020-09-17;M;21;0;0;656;22277;3094
Syddanmark;2020-09-17;M;35;0;1;656;22312;3095
Hovedstaden;2020-09-18;F;133;1;6;657;22445;3101
Midtjylland;2020-09-18;F;37;0;1;657;22482;3102
Nordjylland;2020-09-18;F;21;0;1;657;22503;3103
Sjælland;2020-09-18;F;21;0;0;657;22524;3103
Syddanmark;2020-09-18;F;29;0;3;657;22553;3106
Hovedstaden;2020-09-18;M;127;0;5;657;22680;3111
Midtjylland;2020-09-18;M;32;0;1;657;22712;3112
Nordjylland;2020-09-18;M;25;0;1;657;22737;3113
Sjælland;2020-09-18;M;27;0;1;657;22764;3114
Syddanmark;2020-09-18;M;23;0;0;657;22787;3114
Hovedstaden;2020-09-19;F;114;1;7;658;22901;3121
Midtjylland;2020-09-19;F;23;0;1;658;22924;3122
Nordjylland;2020-09-19;F;14;0;1;658;22938;3123
Sjælland;2020-09-19;F;20;0;1;658;22958;3124
Syddanmark;2020-09-19;F;35;0;2;658;22993;3126
Hovedstaden;2020-09-19;M;114;0;3;658;23107;3129
Midtjylland;2020-09-19;M;26;0;0;658;23133;3129
Nordjylland;2020-09-19;M;17;0;2;658;23150;3131
Sjælland;2020-09-19;M;28;0;2;658;23178;3133
Syddanmark;2020-09-19;M;25;0;1;658;23203;3134
Hovedstaden;2020-09-20;F;105;2;5;660;23308;3139
Midtjylland;2020-09-20;F;21;0;1;660;23329;3140
Nordjylland;2020-09-20;F;24;0;1;660;23353;3141
Sjælland;2020-09-20;F;24;0;0;660;23377;3141
Syddanmark;2020-09-20;F;20;0;2;660;23397;3143
Hovedstaden;2020-09-20;M;122;0;5;660;23519;3148
Midtjylland;2020-09-20;M;30;0;1;660;23549;3149
Nordjylland;2020-09-20;M;18;0;1;660;23567;3150
Sjælland;2020-09-20;M;22;0;0;660;23589;3150
Syddanmark;2020-09-20;M;22;0;1;660;23611;3151
Hovedstaden;2020-09-21;F;137;0;7;660;23748;3158
Midtjylland;2020-09-21;F;42;0;2;660;23790;3160
Nordjylland;2020-09-21;F;22;0;1;660;23812;3161
Sjælland;2020-09-21;F;34;0;1;660;23846;3162
Syddanmark;2020-09-21;F;30;0;1;660;23876;3163
Hovedstaden;2020-09-21;M;161;0;2;660;24037;3165
Midtjylland;2020-09-21;M;23;0;0;660;24060;3165
Nordjylland;2020-09-21;M;36;0;0;660;24096;3165
Sjælland;2020-09-21;M;22;0;1;660;24118;3166
Syddanmark;2020-09-21;M;28;0;0;660;24146;3166
Hovedstaden;2020-09-22;F;153;1;6;661;24299;3172
Midtjylland;2020-09-22;F;50;0;0;661;24349;3172
Nordjylland;2020-09-22;F;21;0;0;661;24370;3172
Sjælland;2020-09-22;F;29;0;0;661;24399;3172
Syddanmark;2020-09-22;F;34;0;1;661;24433;3173
Hovedstaden;2020-09-22;M;148;2;7;663;24581;3180
Midtjylland;2020-09-22;M;43;0;1;663;24624;3181
Nordjylland;2020-09-22;M;32;0;0;663;24656;3181
Sjælland;2020-09-22;M;39;0;2;663;24695;3183
Syddanmark;2020-09-22;M;38;1;3;664;24733;3186
Hovedstaden;2020-09-23;F;145;1;6;665;24878;3192
Midtjylland;2020-09-23;F;52;0;2;665;24930;3194
Nordjylland;2020-09-23;F;24;0;0;665;24954;3194
Sjælland;2020-09-23;F;49;0;2;665;25003;3196
Syddanmark;2020-09-23;F;39;0;1;665;25042;3197
Hovedstaden;2020-09-23;M;155;0;4;665;25197;3201
Midtjylland;2020-09-23;M;72;0;4;665;25269;3205
Nordjylland;2020-09-23;M;25;0;1;665;25294;3206
Sjælland;2020-09-23;M;47;2;5;667;25341;3211
Syddanmark;2020-09-23;M;45;0;1;667;25386;3212
Hovedstaden;2020-09-24;F;142;0;3;667;25528;3215
Midtjylland;2020-09-24;F;58;0;3;667;25586;3218
Nordjylland;2020-09-24;F;20;0;0;667;25606;3218
Sjælland;2020-09-24;F;40;0;1;667;25646;3219
Syddanmark;2020-09-24;F;43;0;4;667;25689;3223
Hovedstaden;2020-09-24;M;146;1;7;668;25835;3230
Midtjylland;2020-09-24;M;55;1;0;669;25890;3230
Nordjylland;2020-09-24;M;18;0;0;669;25908;3230
Sjælland;2020-09-24;M;40;0;2;669;25948;3232
Syddanmark;2020-09-24;M;37;0;5;669;25985;3237
Hovedstaden;2020-09-25;F;103;0;6;669;26088;3243
Midtjylland;2020-09-25;F;52;0;2;669;26140;3245
Nordjylland;2020-09-25;F;13;0;1;669;26153;3246
Sjælland;2020-09-25;F;31;0;2;669;26184;3248
Syddanmark;2020-09-25;F;40;0;0;669;26224;3248
Hovedstaden;2020-09-25;M;104;1;4;670;26328;3252
Midtjylland;2020-09-25;M;52;0;2;670;26380;3254
Nordjylland;2020-09-25;M;27;0;0;670;26407;3254
Sjælland;2020-09-25;M;34;0;2;670;26441;3256
Syddanmark;2020-09-25;M;32;0;1;670;26473;3257
Hovedstaden;2020-09-26;F;84;0;3;670;26557;3260
Midtjylland;2020-09-26;F;50;0;1;670;26607;3261
Nordjylland;2020-09-26;F;15;0;1;670;26622;3262
Sjælland;2020-09-26;F;30;0;2;670;26652;3264
Syddanmark;2020-09-26;F;18;0;1;670;26670;3265
Hovedstaden;2020-09-26;M;95;0;2;670;26765;3267
Midtjylland;2020-09-26;M;42;0;1;670;26807;3268
Nordjylland;2020-09-26;M;17;0;0;670;26824;3268
Sjælland;2020-09-26;M;24;0;2;670;26848;3270
Syddanmark;2020-09-26;M;20;0;0;670;26868;3270
Hovedstaden;2020-09-27;F;103;0;3;670;26971;3273
Midtjylland;2020-09-27;F;47;0;1;670;27018;3274
Nordjylland;2020-09-27;F;9;0;1;670;27027;3275
Sjælland;2020-09-27;F;23;0;0;670;27050;3275
Syddanmark;2020-09-27;F;14;0;0;670;27064;3275
Hovedstaden;2020-09-27;M;81;0;4;670;27145;3279
Midtjylland;2020-09-27;M;32;0;3;670;27177;3282
Nordjylland;2020-09-27;M;13;1;2;671;27190;3284
Sjælland;2020-09-27;M;16;0;0;671;27206;3284
Syddanmark;2020-09-27;M;21;0;0;671;27227;3284
Hovedstaden;2020-09-28;F;118;0;5;671;27345;3289
Midtjylland;2020-09-28;F;52;0;1;671;27397;3290
Nordjylland;2020-09-28;F;15;0;0;671;27412;3290
Sjælland;2020-09-28;F;28;0;0;671;27440;3290
Syddanmark;2020-09-28;F;33;0;2;671;27473;3292
Hovedstaden;2020-09-28;M;94;1;3;672;27567;3295
Midtjylland;2020-09-28;M;57;0;3;672;27624;3298
Nordjylland;2020-09-28;M;25;0;0;672;27649;3298
Sjælland;2020-09-28;M;35;0;1;672;27684;3299
Syddanmark;2020-09-28;M;26;0;2;672;27710;3301
Hovedstaden;2020-09-29;F;100;0;4;672;27810;3305
Midtjylland;2020-09-29;F;56;0;4;672;27866;3309
Nordjylland;2020-09-29;F;17;0;0;672;27883;3309
Sjælland;2020-09-29;F;28;0;0;672;27911;3309
Syddanmark;2020-09-29;F;27;1;1;673;27938;3310
Hovedstaden;2020-09-29;M;91;0;3;673;28029;3313
Midtjylland;2020-09-29;M;51;1;2;674;28080;3315
Nordjylland;2020-09-29;M;27;0;2;674;28107;3317
Sjælland;2020-09-29;M;24;0;1;674;28131;3318
Syddanmark;2020-09-29;M;29;0;1;674;28160;3319
Hovedstaden;2020-09-30;F;97;0;3;674;28257;3322
Midtjylland;2020-09-30;F;46;0;0;674;28303;3322
Nordjylland;2020-09-30;F;13;0;1;674;28316;3323
Sjælland;2020-09-30;F;28;0;3;674;28344;3326
Syddanmark;2020-09-30;F;20;0;1;674;28364;3327
Hovedstaden;2020-09-30;M;78;0;3;674;28442;3330
Midtjylland;2020-09-30;M;48;0;1;674;28490;3331
Nordjylland;2020-09-30;M;26;0;0;674;28516;3331
Sjælland;2020-09-30;M;31;0;0;674;28547;3331
Syddanmark;2020-09-30;M;46;0;1;674;28593;3332
Hovedstaden;2020-10-01;F;90;0;3;674;28683;3335
Midtjylland;2020-10-01;F;54;0;1;674;28737;3336
Nordjylland;2020-10-01;F;20;2;2;676;28757;3338
Sjælland;2020-10-01;F;30;0;0;676;28787;3338
Syddanmark;2020-10-01;F;25;1;0;677;28812;3338
Hovedstaden;2020-10-01;M;74;0;3;677;28886;3341
Midtjylland;2020-10-01;M;54;1;3;678;28940;3344
Nordjylland;2020-10-01;M;21;1;2;679;28961;3346
Sjælland;2020-10-01;M;26;0;0;679;28987;3346
Syddanmark;2020-10-01;M;33;0;2;679;29020;3348
Hovedstaden;2020-10-02;F;74;0;3;679;29094;3351
Midtjylland;2020-10-02;F;39;0;2;679;29133;3353
Nordjylland;2020-10-02;F;19;0;1;679;29152;3354
Sjælland;2020-10-02;F;21;0;0;679;29173;3354
Syddanmark;2020-10-02;F;20;0;0;679;29193;3354
Hovedstaden;2020-10-02;M;67;0;3;679;29260;3357
Midtjylland;2020-10-02;M;62;1;3;680;29322;3360
Nordjylland;2020-10-02;M;17;0;1;680;29339;3361
Sjælland;2020-10-02;M;20;0;1;680;29359;3362
Syddanmark;2020-10-02;M;27;0;0;680;29386;3362
Hovedstaden;2020-10-03;F;79;0;3;680;29465;3365
Midtjylland;2020-10-03;F;27;0;1;680;29492;3366
Nordjylland;2020-10-03;F;12;0;0;680;29504;3366
Sjælland;2020-10-03;F;17;0;0;680;29521;3366
Syddanmark;2020-10-03;F;29;0;0;680;29550;3366
Hovedstaden;2020-10-03;M;67;0;0;680;29617;3366
Midtjylland;2020-10-03;M;43;0;3;680;29660;3369
Nordjylland;2020-10-03;M;19;0;0;680;29679;3369
Sjælland;2020-10-03;M;15;0;0;680;29694;3369
Syddanmark;2020-10-03;M;30;0;0;680;29724;3369
Hovedstaden;2020-10-04;F;63;0;6;680;29787;3375
Midtjylland;2020-10-04;F;29;0;1;680;29816;3376
Nordjylland;2020-10-04;F;11;0;0;680;29827;3376
Sjælland;2020-10-04;F;13;0;0;680;29840;3376
Syddanmark;2020-10-04;F;21;1;0;681;29861;3376
Hovedstaden;2020-10-04;M;83;0;3;681;29944;3379
Midtjylland;2020-10-04;M;29;0;2;681;29973;3381
Nordjylland;2020-10-04;M;19;0;1;681;29992;3382
Sjælland;2020-10-04;M;17;0;2;681;30009;3384
Syddanmark;2020-10-04;M;21;0;2;681;30030;3386
Hovedstaden;2020-10-05;F;90;1;5;682;30120;3391
Midtjylland;2020-10-05;F;55;0;4;682;30175;3395
Nordjylland;2020-10-05;F;19;0;0;682;30194;3395
Sjælland;2020-10-05;F;24;0;1;682;30218;3396
Syddanmark;2020-10-05;F;33;0;0;682;30251;3396
Hovedstaden;2020-10-05;M;72;2;8;684;30323;3404
Midtjylland;2020-10-05;M;50;0;3;684;30373;3407
Nordjylland;2020-10-05;M;41;0;1;684;30414;3408
Sjælland;2020-10-05;M;17;0;2;684;30431;3410
Syddanmark;2020-10-05;M;28;0;0;684;30459;3410
Hovedstaden;2020-10-06;F;91;1;2;685;30550;3412
Midtjylland;2020-10-06;F;35;0;1;685;30585;3413
Nordjylland;2020-10-06;F;15;0;1;685;30600;3414
Sjælland;2020-10-06;F;19;0;0;685;30619;3414
Syddanmark;2020-10-06;F;23;0;1;685;30642;3415
Hovedstaden;2020-10-06;M;103;0;3;685;30745;3418
Midtjylland;2020-10-06;M;73;0;3;685;30818;3421
Nordjylland;2020-10-06;M;16;0;1;685;30834;3422
Sjælland;2020-10-06;M;21;0;1;685;30855;3423
Syddanmark;2020-10-06;M;30;0;1;685;30885;3424
Hovedstaden;2020-10-07;F;80;3;7;688;30965;3431
Midtjylland;2020-10-07;F;47;0;2;688;31012;3433
Nordjylland;2020-10-07;F;24;0;1;688;31036;3434
Sjælland;2020-10-07;F;18;0;0;688;31054;3434
Syddanmark;2020-10-07;F;32;1;1;689;31086;3435
Hovedstaden;2020-10-07;M;78;1;5;690;31164;3440
Midtjylland;2020-10-07;M;105;0;4;690;31269;3444
Nordjylland;2020-10-07;M;25;0;0;690;31294;3444
Sjælland;2020-10-07;M;19;0;1;690;31313;3445
Syddanmark;2020-10-07;M;24;2;1;692;31337;3446
Hovedstaden;2020-10-08;F;73;0;1;692;31410;3447
Midtjylland;2020-10-08;F;67;0;2;692;31477;3449
Nordjylland;2020-10-08;F;20;0;0;692;31497;3449
Sjælland;2020-10-08;F;15;1;2;693;31512;3451
Syddanmark;2020-10-08;F;27;0;0;693;31539;3451
Hovedstaden;2020-10-08;M;80;0;3;693;31619;3454
Midtjylland;2020-10-08;M;70;0;3;693;31689;3457
Nordjylland;2020-10-08;M;30;0;2;693;31719;3459
Sjælland;2020-10-08;M;13;0;0;693;31732;3459
Syddanmark;2020-10-08;M;28;0;1;693;31760;3460
Hovedstaden;2020-10-09;F;72;1;4;694;31832;3464
Midtjylland;2020-10-09;F;55;0;4;694;31887;3468
Nordjylland;2020-10-09;F;22;0;0;694;31909;3468
Sjælland;2020-10-09;F;16;0;0;694;31925;3468
Syddanmark;2020-10-09;F;34;0;1;694;31959;3469
Hovedstaden;2020-10-09;M;80;0;3;694;32039;3472
Midtjylland;2020-10-09;M;61;0;2;694;32100;3474
Nordjylland;2020-10-09;M;21;0;0;694;32121;3474
Sjælland;2020-10-09;M;14;0;1;694;32135;3475
Syddanmark;2020-10-09;M;37;2;3;696;32172;3478
Hovedstaden;2020-10-10;F;48;0;3;696;32220;3481
Midtjylland;2020-10-10;F;39;0;1;696;32259;3482
Nordjylland;2020-10-10;F;14;0;1;696;32273;3483
Sjælland;2020-10-10;F;13;0;0;696;32286;3483
Syddanmark;2020-10-10;F;16;0;0;696;32302;3483
Hovedstaden;2020-10-10;M;60;0;5;696;32362;3488
Midtjylland;2020-10-10;M;48;0;3;696;32410;3491
Nordjylland;2020-10-10;M;18;0;1;696;32428;3492
Sjælland;2020-10-10;M;12;0;1;696;32440;3493
Syddanmark;2020-10-10;M;13;0;0;696;32453;3493
Hovedstaden;2020-10-11;F;54;1;6;697;32507;3499
Midtjylland;2020-10-11;F;34;0;1;697;32541;3500
Nordjylland;2020-10-11;F;12;0;0;697;32553;3500
Sjælland;2020-10-11;F;16;0;1;697;32569;3501
Syddanmark;2020-10-11;F;18;0;0;697;32587;3501
Hovedstaden;2020-10-11;M;44;0;1;697;32631;3502
Midtjylland;2020-10-11;M;32;0;2;697;32663;3504
Nordjylland;2020-10-11;M;18;1;1;698;32681;3505
Sjælland;2020-10-11;M;13;0;0;698;32694;3505
Syddanmark;2020-10-11;M;15;0;2;698;32709;3507
Hovedstaden;2020-10-12;F;65;1;3;699;32774;3510
Midtjylland;2020-10-12;F;62;1;3;700;32836;3513
Nordjylland;2020-10-12;F;21;0;0;700;32857;3513
Sjælland;2020-10-12;F;17;0;2;700;32874;3515
Syddanmark;2020-10-12;F;39;0;2;700;32913;3517
Hovedstaden;2020-10-12;M;76;1;4;701;32989;3521
Midtjylland;2020-10-12;M;66;0;2;701;33055;3523
Nordjylland;2020-10-12;M;24;0;3;701;33079;3526
Sjælland;2020-10-12;M;53;0;2;701;33132;3528
Syddanmark;2020-10-12;M;34;1;4;702;33166;3532
Hovedstaden;2020-10-13;F;88;0;4;702;33254;3536
Midtjylland;2020-10-13;F;42;0;5;702;33296;3541
Nordjylland;2020-10-13;F;21;1;0;703;33317;3541
Sjælland;2020-10-13;F;13;0;2;703;33330;3543
Syddanmark;2020-10-13;F;44;0;4;703;33374;3547
Hovedstaden;2020-10-13;M;69;1;4;704;33443;3551
Midtjylland;2020-10-13;M;53;0;0;704;33496;3551
Nordjylland;2020-10-13;M;34;0;0;704;33530;3551
Sjælland;2020-10-13;M;11;0;0;704;33541;3551
Syddanmark;2020-10-13;M;50;1;1;705;33591;3552
Hovedstaden;2020-10-14;F;98;0;6;705;33689;3558
Midtjylland;2020-10-14;F;46;0;2;705;33735;3560
Nordjylland;2020-10-14;F;31;1;1;706;33766;3561
Sjælland;2020-10-14;F;11;0;0;706;33777;3561
Syddanmark;2020-10-14;F;34;0;0;706;33811;3561
Hovedstaden;2020-10-14;M;103;2;8;708;33914;3569
Midtjylland;2020-10-14;M;50;1;2;709;33964;3571
Nordjylland;2020-10-14;M;31;1;3;710;33995;3574
Sjælland;2020-10-14;M;25;0;0;710;34020;3574
Syddanmark;2020-10-14;M;40;0;2;710;34060;3576
Hovedstaden;2020-10-15;F;94;0;4;710;34154;3580
Midtjylland;2020-10-15;F;54;0;1;710;34208;3581
Nordjylland;2020-10-15;F;18;0;0;710;34226;3581
Sjælland;2020-10-15;F;13;0;2;710;34239;3583
Syddanmark;2020-10-15;F;38;0;3;710;34277;3586
Hovedstaden;2020-10-15;M;87;1;7;711;34364;3593
Midtjylland;2020-10-15;M;58;0;3;711;34422;3596
Nordjylland;2020-10-15;M;15;0;0;711;34437;3596
Sjælland;2020-10-15;M;26;0;1;711;34463;3597
Syddanmark;2020-10-15;M;47;0;1;711;34510;3598
Hovedstaden;2020-10-16;F;107;1;7;712;34617;3605
Midtjylland;2020-10-16;F;60;0;1;712;34677;3606
Nordjylland;2020-10-16;F;28;0;0;712;34705;3606
Sjælland;2020-10-16;F;25;0;0;712;34730;3606
Syddanmark;2020-10-16;F;32;0;1;712;34762;3607
Hovedstaden;2020-10-16;M;81;1;3;713;34843;3610
Midtjylland;2020-10-16;M;45;0;1;713;34888;3611
Nordjylland;2020-10-16;M;21;1;1;714;34909;3612
Sjælland;2020-10-16;M;22;0;4;714;34931;3616
Syddanmark;2020-10-16;M;45;0;4;714;34976;3620
Hovedstaden;2020-10-17;F;103;0;6;714;35079;3626
Midtjylland;2020-10-17;F;36;0;1;714;35115;3627
Nordjylland;2020-10-17;F;21;0;0;714;35136;3627
Sjælland;2020-10-17;F;12;0;0;714;35148;3627
Syddanmark;2020-10-17;F;40;0;0;714;35188;3627
Hovedstaden;2020-10-17;M;114;0;7;714;35302;3634
Midtjylland;2020-10-17;M;39;0;2;714;35341;3636
Nordjylland;2020-10-17;M;21;0;3;714;35362;3639
Sjælland;2020-10-17;M;16;0;0;714;35378;3639
Syddanmark;2020-10-17;M;29;0;0;714;35407;3639
Hovedstaden;2020-10-18;F;103;0;6;714;35510;3645
Midtjylland;2020-10-18;F;39;0;3;714;35549;3648
Nordjylland;2020-10-18;F;19;0;1;714;35568;3649
Sjælland;2020-10-18;F;20;0;0;714;35588;3649
Syddanmark;2020-10-18;F;44;0;2;714;35632;3651
Hovedstaden;2020-10-18;M;123;0;8;714;35755;3659
Midtjylland;2020-10-18;M;32;0;3;714;35787;3662
Nordjylland;2020-10-18;M;24;1;3;715;35811;3665
Sjælland;2020-10-18;M;15;0;0;715;35826;3665
Syddanmark;2020-10-18;M;33;2;3;717;35859;3668
Hovedstaden;2020-10-19;F;144;0;6;717;36003;3674
Midtjylland;2020-10-19;F;66;2;2;719;36069;3676
Nordjylland;2020-10-19;F;37;1;1;720;36106;3677
Sjælland;2020-10-19;F;32;0;0;720;36138;3677
Syddanmark;2020-10-19;F;51;0;2;720;36189;3679
Hovedstaden;2020-10-19;M;149;1;5;721;36338;3684
Midtjylland;2020-10-19;M;74;0;0;721;36412;3684
Nordjylland;2020-10-19;M;35;0;0;721;36447;3684
Sjælland;2020-10-19;M;36;0;1;721;36483;3685
Syddanmark;2020-10-19;M;64;0;2;721;36547;3687
Hovedstaden;2020-10-20;F;155;0;3;721;36702;3690
Midtjylland;2020-10-20;F;80;0;2;721;36782;3692
Nordjylland;2020-10-20;F;43;1;2;722;36825;3694
Sjælland;2020-10-20;F;34;0;4;722;36859;3698
Syddanmark;2020-10-20;F;58;0;5;722;36917;3703
Hovedstaden;2020-10-20;M;163;2;8;724;37080;3711
Midtjylland;2020-10-20;M;111;0;3;724;37191;3714
Nordjylland;2020-10-20;M;41;2;0;726;37232;3714
Sjælland;2020-10-20;M;36;0;2;726;37268;3716
Syddanmark;2020-10-20;M;59;0;3;726;37327;3719
Hovedstaden;2020-10-21;F;152;1;5;727;37479;3724
Midtjylland;2020-10-21;F;115;0;6;727;37594;3730
Nordjylland;2020-10-21;F;45;0;1;727;37639;3731
Sjælland;2020-10-21;F;37;0;2;727;37676;3733
Syddanmark;2020-10-21;F;46;0;0;727;37722;3733
Hovedstaden;2020-10-21;M;178;2;8;729;37900;3741
Midtjylland;2020-10-21;M;119;0;4;729;38019;3745
Nordjylland;2020-10-21;M;47;1;1;730;38066;3746
Sjælland;2020-10-21;M;39;0;0;730;38105;3746
Syddanmark;2020-10-21;M;70;0;0;730;38175;3746
Hovedstaden;2020-10-22;F;202;2;9;732;38377;3755
Midtjylland;2020-10-22;F;77;1;1;733;38454;3756
Nordjylland;2020-10-22;F;49;0;0;733;38503;3756
Sjælland;2020-10-22;F;36;0;1;733;38539;3757
Syddanmark;2020-10-22;F;58;0;2;733;38597;3759
Hovedstaden;2020-10-22;M;205;1;8;734;38802;3767
Midtjylland;2020-10-22;M;74;0;3;734;38876;3770
Nordjylland;2020-10-22;M;53;0;1;734;38929;3771
Sjælland;2020-10-22;M;39;0;0;734;38968;3771
Syddanmark;2020-10-22;M;73;1;3;735;39041;3774
Hovedstaden;2020-10-23;F;181;0;8;735;39222;3782
Midtjylland;2020-10-23;F;74;0;0;735;39296;3782
Nordjylland;2020-10-23;F;54;0;0;735;39350;3782
Sjælland;2020-10-23;F;37;0;0;735;39387;3782
Syddanmark;2020-10-23;F;56;0;1;735;39443;3783
Hovedstaden;2020-10-23;M;189;0;3;735;39632;3786
Midtjylland;2020-10-23;M;100;0;1;735;39732;3787
Nordjylland;2020-10-23;M;63;0;3;735;39795;3790
Sjælland;2020-10-23;M;42;0;3;735;39837;3793
Syddanmark;2020-10-23;M;64;0;4;735;39901;3797
Hovedstaden;2020-10-24;F;186;2;7;737;40087;3804
Midtjylland;2020-10-24;F;69;0;4;737;40156;3808
Nordjylland;2020-10-24;F;58;0;2;737;40214;3810
Sjælland;2020-10-24;F;41;0;1;737;40255;3811
Syddanmark;2020-10-24;F;44;0;1;737;40299;3812
Hovedstaden;2020-10-24;M;199;1;9;738;40498;3821
Midtjylland;2020-10-24;M;75;0;2;738;40573;3823
Nordjylland;2020-10-24;M;46;0;2;738;40619;3825
Sjælland;2020-10-24;M;48;0;5;738;40667;3830
Syddanmark;2020-10-24;M;53;0;1;738;40720;3831
Hovedstaden;2020-10-25;F;211;0;9;738;40931;3840
Midtjylland;2020-10-25;F;81;0;0;738;41012;3840
Nordjylland;2020-10-25;F;67;0;3;738;41079;3843
Sjælland;2020-10-25;F;44;0;2;738;41123;3845
Syddanmark;2020-10-25;F;67;0;2;738;41190;3847
Hovedstaden;2020-10-25;M;229;0;6;738;41419;3853
Midtjylland;2020-10-25;M;75;0;0;738;41494;3853
Nordjylland;2020-10-25;M;42;0;1;738;41536;3854
Sjælland;2020-10-25;M;35;0;1;738;41571;3855
Syddanmark;2020-10-25;M;67;0;2;738;41638;3857
Hovedstaden;2020-10-26;F;230;0;11;738;41868;3868
Midtjylland;2020-10-26;F;88;0;3;738;41956;3871
Nordjylland;2020-10-26;F;54;1;2;739;42010;3873
Sjælland;2020-10-26;F;46;0;4;739;42056;3877
Syddanmark;2020-10-26;F;77;0;1;739;42133;3878
Hovedstaden;2020-10-26;M;216;0;5;739;42349;3883
Midtjylland;2020-10-26;M;75;0;3;739;42424;3886
Nordjylland;2020-10-26;M;78;0;4;739;42502;3890
Sjælland;2020-10-26;M;53;0;2;739;42555;3892
Syddanmark;2020-10-26;M;90;0;7;739;42645;3899
Hovedstaden;2020-10-27;F;303;1;13;740;42948;3912
Midtjylland;2020-10-27;F;114;0;1;740;43062;3913
Nordjylland;2020-10-27;F;69;0;3;740;43131;3916
Sjælland;2020-10-27;F;67;0;2;740;43198;3918
Syddanmark;2020-10-27;F;69;0;4;740;43267;3922
Hovedstaden;2020-10-27;M;272;0;5;740;43539;3927
Midtjylland;2020-10-27;M;127;0;6;740;43666;3933
Nordjylland;2020-10-27;M;79;2;4;742;43745;3937
Sjælland;2020-10-27;M;68;0;0;742;43813;3937
Syddanmark;2020-10-27;M;76;0;7;742;43889;3944
Hovedstaden;2020-10-28;F;258;0;10;742;44147;3954
Midtjylland;2020-10-28;F;122;1;5;743;44269;3959
Nordjylland;2020-10-28;F;61;0;3;743;44330;3962
Sjælland;2020-10-28;F;67;0;0;743;44397;3962
Syddanmark;2020-10-28;F;76;0;6;743;44473;3968
Hovedstaden;2020-10-28;M;271;3;10;746;44744;3978
Midtjylland;2020-10-28;M;108;0;4;746;44852;3982
Nordjylland;2020-10-28;M;55;0;4;746;44907;3986
Sjælland;2020-10-28;M;74;1;1;747;44981;3987
Syddanmark;2020-10-28;M;111;0;3;747;45092;3990
Hovedstaden;2020-10-29;F;220;1;5;748;45312;3995
Midtjylland;2020-10-29;F;57;0;5;748;45369;4000
Nordjylland;2020-10-29;F;50;0;2;748;45419;4002
Sjælland;2020-10-29;F;53;0;3;748;45472;4005
Syddanmark;2020-10-29;F;73;0;1;748;45545;4006
Hovedstaden;2020-10-29;M;239;2;9;750;45784;4015
Midtjylland;2020-10-29;M;84;0;1;750;45868;4016
Nordjylland;2020-10-29;M;71;0;2;750;45939;4018
Sjælland;2020-10-29;M;67;1;2;751;46006;4020
Syddanmark;2020-10-29;M;99;1;6;752;46105;4026
Hovedstaden;2020-10-30;F;239;0;7;752;46344;4033
Midtjylland;2020-10-30;F;98;0;3;752;46442;4036
Nordjylland;2020-10-30;F;57;0;1;752;46499;4037
Sjælland;2020-10-30;F;83;0;2;752;46582;4039
Syddanmark;2020-10-30;F;57;0;3;752;46639;4042
Hovedstaden;2020-10-30;M;255;1;11;753;46894;4053
Midtjylland;2020-10-30;M;97;3;5;756;46991;4058
Nordjylland;2020-10-30;M;56;0;3;756;47047;4061
Sjælland;2020-10-30;M;69;1;2;757;47116;4063
Syddanmark;2020-10-30;M;70;0;1;757;47186;4064
Hovedstaden;2020-10-31;F;246;1;7;758;47432;4071
Midtjylland;2020-10-31;F;91;0;1;758;47523;4072
Nordjylland;2020-10-31;F;48;0;0;758;47571;4072
Sjælland;2020-10-31;F;56;0;3;758;47627;4075
Syddanmark;2020-10-31;F;41;1;2;759;47668;4077
Hovedstaden;2020-10-31;M;258;0;12;759;47926;4089
Midtjylland;2020-10-31;M;78;0;3;759;48004;4092
Nordjylland;2020-10-31;M;48;0;0;759;48052;4092
Sjælland;2020-10-31;M;52;0;0;759;48104;4092
Syddanmark;2020-10-31;M;58;0;1;759;48162;4093
Hovedstaden;2020-11-01;F;236;1;9;760;48398;4102
Midtjylland;2020-11-01;F;88;1;5;761;48486;4107
Nordjylland;2020-11-01;F;51;0;1;761;48537;4108
Sjælland;2020-11-01;F;41;0;1;761;48578;4109
Syddanmark;2020-11-01;F;75;2;4;763;48653;4113
Hovedstaden;2020-11-01;M;229;0;9;763;48882;4122
Midtjylland;2020-11-01;M;85;0;2;763;48967;4124
Nordjylland;2020-11-01;M;45;1;2;764;49012;4126
Sjælland;2020-11-01;M;43;0;3;764;49055;4129
Syddanmark;2020-11-01;M;64;0;3;764;49119;4132
Hovedstaden;2020-11-02;F;319;2;9;766;49438;4141
Midtjylland;2020-11-02;F;101;0;3;766;49539;4144
Nordjylland;2020-11-02;F;59;1;2;767;49598;4146
Sjælland;2020-11-02;F;90;0;2;767;49688;4148
Syddanmark;2020-11-02;F;89;1;3;768;49777;4151
Hovedstaden;2020-11-02;M;286;1;7;769;50063;4158
Midtjylland;2020-11-02;M;105;0;3;769;50168;4161
Nordjylland;2020-11-02;M;57;0;0;769;50225;4161
Sjælland;2020-11-02;M;93;0;1;769;50318;4162
Syddanmark;2020-11-02;M;73;0;5;769;50391;4167
Hovedstaden;2020-11-03;F;304;2;14;771;50695;4181
Midtjylland;2020-11-03;F;109;0;0;771;50804;4181
Nordjylland;2020-11-03;F;75;0;4;771;50879;4185
Sjælland;2020-11-03;F;78;1;5;772;50957;4190
Syddanmark;2020-11-03;F;79;0;7;772;51036;4197
Hovedstaden;2020-11-03;M;275;0;10;772;51311;4207
Midtjylland;2020-11-03;M;104;0;5;772;51415;4212
Nordjylland;2020-11-03;M;62;1;3;773;51477;4215
Sjælland;2020-11-03;M;68;0;2;773;51545;4217
Syddanmark;2020-11-03;M;103;0;2;773;51648;4219
Hovedstaden;2020-11-04;F;282;0;10;773;51930;4229
Midtjylland;2020-11-04;F;126;1;2;774;52056;4231
Nordjylland;2020-11-04;F;39;0;1;774;52095;4232
Sjælland;2020-11-04;F;97;3;6;777;52192;4238
Syddanmark;2020-11-04;F;75;0;3;777;52267;4241
Hovedstaden;2020-11-04;M;302;1;11;778;52569;4252
Midtjylland;2020-11-04;M;108;1;5;779;52677;4257
Nordjylland;2020-11-04;M;44;0;1;779;52721;4258
Sjælland;2020-11-04;M;75;1;6;780;52796;4264
Syddanmark;2020-11-04;M;97;0;4;780;52893;4268
Hovedstaden;2020-11-05;F;239;2;9;782;53132;4277
Midtjylland;2020-11-05;F;102;0;4;782;53234;4281
Nordjylland;2020-11-05;F;45;1;3;783;53279;4284
Sjælland;2020-11-05;F;61;0;4;783;53340;4288
Syddanmark;2020-11-05;F;69;0;5;783;53409;4293
Hovedstaden;2020-11-05;M;233;1;6;784;53642;4299
Midtjylland;2020-11-05;M;80;0;5;784;53722;4304
Nordjylland;2020-11-05;M;38;1;1;785;53760;4305
Sjælland;2020-11-05;M;79;0;4;785;53839;4309
Syddanmark;2020-11-05;M;81;0;3;785;53920;4312
Hovedstaden;2020-11-06;F;209;0;10;785;54129;4322
Midtjylland;2020-11-06;F;77;2;2;787;54206;4324
Nordjylland;2020-11-06;F;29;0;1;787;54235;4325
Sjælland;2020-11-06;F;71;0;1;787;54306;4326
Syddanmark;2020-11-06;F;66;0;2;787;54372;4328
Hovedstaden;2020-11-06;M;254;2;13;789;54626;4341
Midtjylland;2020-11-06;M;85;0;8;789;54711;4349
Nordjylland;2020-11-06;M;31;0;0;789;54742;4349
Sjælland;2020-11-06;M;73;0;3;789;54815;4352
Syddanmark;2020-11-06;M;64;0;2;789;54879;4354
Hovedstaden;2020-11-07;F;194;0;0;789;55073;4354
Midtjylland;2020-11-07;F;89;0;1;789;55162;4355
Nordjylland;2020-11-07;F;29;0;2;789;55191;4357
Sjælland;2020-11-07;F;58;0;2;789;55249;4359
Syddanmark;2020-11-07;F;55;0;0;789;55304;4359
Hovedstaden;2020-11-07;M;191;0;5;789;55495;4364
Midtjylland;2020-11-07;M;85;0;3;789;55580;4367
Nordjylland;2020-11-07;M;39;0;0;789;55619;4367
Sjælland;2020-11-07;M;57;2;3;791;55676;4370
Syddanmark;2020-11-07;M;47;0;2;791;55723;4372
Hovedstaden;2020-11-08;F;159;1;6;792;55882;4378
Midtjylland;2020-11-08;F;75;0;2;792;55957;4380
Nordjylland;2020-11-08;F;20;1;1;793;55977;4381
Sjælland;2020-11-08;F;41;0;1;793;56018;4382
Syddanmark;2020-11-08;F;49;0;2;793;56067;4384
Hovedstaden;2020-11-08;M;193;0;9;793;56260;4393
Midtjylland;2020-11-08;M;79;1;3;794;56339;4396
Nordjylland;2020-11-08;M;21;0;0;794;56360;4396
Sjælland;2020-11-08;M;49;0;4;794;56409;4400
Syddanmark;2020-11-08;M;51;0;1;794;56460;4401
Hovedstaden;2020-11-09;F;229;0;13;794;56689;4414
Midtjylland;2020-11-09;F;90;2;6;796;56779;4420
Nordjylland;2020-11-09;F;40;0;1;796;56819;4421
Sjælland;2020-11-09;F;69;0;3;796;56888;4424
Syddanmark;2020-11-09;F;76;0;2;796;56964;4426
Hovedstaden;2020-11-09;M;255;3;12;799;57219;4438
Midtjylland;2020-11-09;M;114;3;5;802;57333;4443
Nordjylland;2020-11-09;M;32;0;4;802;57365;4447
Sjælland;2020-11-09;M;49;0;3;802;57414;4450
Syddanmark;2020-11-09;M;89;0;5;802;57503;4455
Hovedstaden;2020-11-10;F;276;0;11;802;57779;4466
Midtjylland;2020-11-10;F;123;1;7;803;57902;4473
Nordjylland;2020-11-10;F;30;0;2;803;57932;4475
Sjælland;2020-11-10;F;81;0;6;803;58013;4481
Syddanmark;2020-11-10;F;72;0;2;803;58085;4483
Hovedstaden;2020-11-10;M;220;0;7;803;58305;4490
Midtjylland;2020-11-10;M;103;0;1;803;58408;4491
Nordjylland;2020-11-10;M;31;0;0;803;58439;4491
Sjælland;2020-11-10;M;66;0;4;803;58505;4495
Syddanmark;2020-11-10;M;54;0;1;803;58559;4496
Hovedstaden;2020-11-11;F;218;1;7;804;58777;4503
Midtjylland;2020-11-11;F;131;0;2;804;58908;4505
Nordjylland;2020-11-11;F;27;0;1;804;58935;4506
Sjælland;2020-11-11;F;67;0;1;804;59002;4507
Syddanmark;2020-11-11;F;71;0;1;804;59073;4508
Hovedstaden;2020-11-11;M;223;2;9;806;59296;4517
Midtjylland;2020-11-11;M;133;2;9;808;59429;4526
Nordjylland;2020-11-11;M;43;0;1;808;59472;4527
Sjælland;2020-11-11;M;85;0;4;808;59557;4531
Syddanmark;2020-11-11;M;91;1;6;809;59648;4537
Hovedstaden;2020-11-12;F;237;3;10;812;59885;4547
Midtjylland;2020-11-12;F;126;1;6;813;60011;4553
Nordjylland;2020-11-12;F;28;1;0;814;60039;4553
Sjælland;2020-11-12;F;45;0;2;814;60084;4555
Syddanmark;2020-11-12;F;70;0;0;814;60154;4555
Hovedstaden;2020-11-12;M;238;2;10;816;60392;4565
Midtjylland;2020-11-12;M;122;2;4;818;60514;4569
Nordjylland;2020-11-12;M;39;0;1;818;60553;4570
Sjælland;2020-11-12;M;73;0;0;818;60626;4570
Syddanmark;2020-11-12;M;74;0;2;818;60700;4572
Hovedstaden;2020-11-13;F;262;3;13;821;60962;4585
Midtjylland;2020-11-13;F;109;0;4;821;61071;4589
Nordjylland;2020-11-13;F;35;0;2;821;61106;4591
Sjælland;2020-11-13;F;68;0;4;821;61174;4595
Syddanmark;2020-11-13;F;69;0;4;821;61243;4599
Hovedstaden;2020-11-13;M;257;1;6;822;61500;4605
Midtjylland;2020-11-13;M;124;1;8;823;61624;4613
Nordjylland;2020-11-13;M;42;0;0;823;61666;4613
Sjælland;2020-11-13;M;83;0;6;823;61749;4619
Syddanmark;2020-11-13;M;99;0;0;823;61848;4619
Hovedstaden;2020-11-14;F;237;0;11;823;62085;4630
Midtjylland;2020-11-14;F;99;2;3;825;62184;4633
Nordjylland;2020-11-14;F;31;0;0;825;62215;4633
Sjælland;2020-11-14;F;59;0;3;825;62274;4636
Syddanmark;2020-11-14;F;85;0;2;825;62359;4638
Hovedstaden;2020-11-14;M;232;0;7;825;62591;4645
Midtjylland;2020-11-14;M;125;0;4;825;62716;4649
Nordjylland;2020-11-14;M;34;0;3;825;62750;4652
Sjælland;2020-11-14;M;44;0;2;825;62794;4654
Syddanmark;2020-11-14;M;97;1;3;826;62891;4657
Hovedstaden;2020-11-15;F;222;1;8;827;63113;4665
Midtjylland;2020-11-15;F;92;0;2;827;63205;4667
Nordjylland;2020-11-15;F;29;0;1;827;63234;4668
Sjælland;2020-11-15;F;50;0;1;827;63284;4669
Syddanmark;2020-11-15;F;80;0;3;827;63364;4672
Hovedstaden;2020-11-15;M;230;0;5;827;63594;4677
Midtjylland;2020-11-15;M;113;0;2;827;63707;4679
Nordjylland;2020-11-15;M;44;0;0;827;63751;4679
Sjælland;2020-11-15;M;60;0;2;827;63811;4681
Syddanmark;2020-11-15;M;70;1;3;828;63881;4684
Hovedstaden;2020-11-16;F;261;0;6;828;64142;4690
Midtjylland;2020-11-16;F;146;0;3;828;64288;4693
Nordjylland;2020-11-16;F;27;0;0;828;64315;4693
Sjælland;2020-11-16;F;59;0;1;828;64374;4694
Syddanmark;2020-11-16;F;107;0;2;828;64481;4696
Hovedstaden;2020-11-16;M;289;2;13;830;64770;4709
Midtjylland;2020-11-16;M;155;1;9;831;64925;4718
Nordjylland;2020-11-16;M;31;1;4;832;64956;4722
Sjælland;2020-11-16;M;84;0;5;832;65040;4727
Syddanmark;2020-11-16;M;93;0;2;832;65133;4729
Hovedstaden;2020-11-17;F;277;0;17;832;65410;4746
Midtjylland;2020-11-17;F;148;0;4;832;65558;4750
Nordjylland;2020-11-17;F;34;0;1;832;65592;4751
Sjælland;2020-11-17;F;68;0;1;832;65660;4752
Syddanmark;2020-11-17;F;112;0;2;832;65772;4754
Hovedstaden;2020-11-17;M;314;1;9;833;66086;4763
Midtjylland;2020-11-17;M;152;0;7;833;66238;4770
Nordjylland;2020-11-17;M;31;1;2;834;66269;4772
Sjælland;2020-11-17;M;69;1;3;835;66338;4775
Syddanmark;2020-11-17;M;126;0;4;835;66464;4779
Hovedstaden;2020-11-18;F;287;0;8;835;66751;4787
Midtjylland;2020-11-18;F;157;1;8;836;66908;4795
Nordjylland;2020-11-18;F;25;0;0;836;66933;4795
Sjælland;2020-11-18;F;66;0;1;836;66999;4796
Syddanmark;2020-11-18;F;104;0;1;836;67103;4797
Hovedstaden;2020-11-18;M;305;4;11;840;67408;4808
Midtjylland;2020-11-18;M;141;0;5;840;67549;4813
Nordjylland;2020-11-18;M;28;0;1;840;67577;4814
Sjælland;2020-11-18;M;81;0;6;840;67658;4820
Syddanmark;2020-11-18;M;137;0;7;840;67795;4827
Hovedstaden;2020-11-19;F;282;4;9;844;68077;4836
Midtjylland;2020-11-19;F;131;5;5;849;68208;4841
Nordjylland;2020-11-19;F;25;0;3;849;68233;4844
Sjælland;2020-11-19;F;59;0;3;849;68292;4847
Syddanmark;2020-11-19;F;101;0;2;849;68393;4849
Hovedstaden;2020-11-19;M;291;0;7;849;68684;4856
Midtjylland;2020-11-19;M;110;2;5;851;68794;4861
Nordjylland;2020-11-19;M;19;0;2;851;68813;4863
Sjælland;2020-11-19;M;81;0;5;851;68894;4868
Syddanmark;2020-11-19;M;122;1;4;852;69016;4872
Hovedstaden;2020-11-20;F;285;6;10;858;69301;4882
Midtjylland;2020-11-20;F;112;5;5;863;69413;4887
Nordjylland;2020-11-20;F;32;1;4;864;69445;4891
Sjælland;2020-11-20;F;79;0;4;864;69524;4895
Syddanmark;2020-11-20;F;109;0;2;864;69633;4897
Hovedstaden;2020-11-20;M;266;1;6;865;69899;4903
Midtjylland;2020-11-20;M;104;3;5;868;70003;4908
Nordjylland;2020-11-20;M;32;1;2;869;70035;4910
Sjælland;2020-11-20;M;79;1;3;870;70114;4913
Syddanmark;2020-11-20;M;126;1;3;871;70240;4916
Hovedstaden;2020-11-21;F;235;0;11;871;70475;4927
Midtjylland;2020-11-21;F;80;0;1;871;70555;4928
Nordjylland;2020-11-21;F;17;0;2;871;70572;4930
Sjælland;2020-11-21;F;56;0;2;871;70628;4932
Syddanmark;2020-11-21;F;68;1;3;872;70696;4935
Hovedstaden;2020-11-21;M;280;2;10;874;70976;4945
Midtjylland;2020-11-21;M;98;0;3;874;71074;4948
Nordjylland;2020-11-21;M;19;0;3;874;71093;4951
Sjælland;2020-11-21;M;55;1;0;875;71148;4951
Syddanmark;2020-11-21;M;93;0;1;875;71241;4952
Hovedstaden;2020-11-22;F;261;1;8;876;71502;4960
Midtjylland;2020-11-22;F;99;0;2;876;71601;4962
Nordjylland;2020-11-22;F;23;0;2;876;71624;4964
Sjælland;2020-11-22;F;39;1;1;877;71663;4965
Syddanmark;2020-11-22;F;76;0;1;877;71739;4966
Hovedstaden;2020-11-22;M;254;4;16;881;71993;4982
Midtjylland;2020-11-22;M;93;0;2;881;72086;4984
Nordjylland;2020-11-22;M;15;0;1;881;72101;4985
Sjælland;2020-11-22;M;56;0;3;881;72157;4988
Syddanmark;2020-11-22;M;93;0;2;881;72250;4990
Hovedstaden;2020-11-23;F;292;3;14;884;72542;5004
Midtjylland;2020-11-23;F;97;0;2;884;72639;5006
Nordjylland;2020-11-23;F;20;0;1;884;72659;5007
Sjælland;2020-11-23;F;76;1;3;885;72735;5010
Syddanmark;2020-11-23;F;115;1;8;886;72850;5018
Hovedstaden;2020-11-23;M;300;3;14;889;73150;5032
Midtjylland;2020-11-23;M;94;2;6;891;73244;5038
Nordjylland;2020-11-23;M;15;0;0;891;73259;5038
Sjælland;2020-11-23;M;68;0;3;891;73327;5041
Syddanmark;2020-11-23;M;112;0;2;891;73439;5043
Hovedstaden;2020-11-24;F;337;3;6;894;73776;5049
Midtjylland;2020-11-24;F;123;1;3;895;73899;5052
Nordjylland;2020-11-24;F;21;0;0;895;73920;5052
Sjælland;2020-11-24;F;77;0;2;895;73997;5054
Syddanmark;2020-11-24;F;96;0;0;895;74093;5054
Hovedstaden;2020-11-24;M;337;1;19;896;74430;5073
Midtjylland;2020-11-24;M;115;1;9;897;74545;5082
Nordjylland;2020-11-24;M;21;0;0;897;74566;5082
Sjælland;2020-11-24;M;74;0;5;897;74640;5087
Syddanmark;2020-11-24;M;128;0;6;897;74768;5093
Hovedstaden;2020-11-25;F;334;1;7;898;75102;5100
Midtjylland;2020-11-25;F;100;0;5;898;75202;5105
Nordjylland;2020-11-25;F;26;0;1;898;75228;5106
Sjælland;2020-11-25;F;81;0;2;898;75309;5108
Syddanmark;2020-11-25;F;89;0;2;898;75398;5110
Hovedstaden;2020-11-25;M;335;0;6;898;75733;5116
Midtjylland;2020-11-25;M;135;2;10;900;75868;5126
Nordjylland;2020-11-25;M;20;1;2;901;75888;5128
Sjælland;2020-11-25;M;89;3;7;904;75977;5135
Syddanmark;2020-11-25;M;107;1;8;905;76084;5143
Hovedstaden;2020-11-26;F;319;0;6;905;76403;5149
Midtjylland;2020-11-26;F;117;2;5;907;76520;5154
Nordjylland;2020-11-26;F;25;0;1;907;76545;5155
Sjælland;2020-11-26;F;94;0;4;907;76639;5159
Syddanmark;2020-11-26;F;99;0;3;907;76738;5162
Hovedstaden;2020-11-26;M;300;5;14;912;77038;5176
Midtjylland;2020-11-26;M;130;0;2;912;77168;5178
Nordjylland;2020-11-26;M;20;0;0;912;77188;5178
Sjælland;2020-11-26;M;71;1;5;913;77259;5183
Syddanmark;2020-11-26;M;82;0;2;913;77341;5185
Hovedstaden;2020-11-27;F;345;7;20;920;77686;5205
Midtjylland;2020-11-27;F;115;1;6;921;77801;5211
Nordjylland;2020-11-27;F;16;0;2;921;77817;5213
Sjælland;2020-11-27;F;60;0;1;921;77877;5214
Syddanmark;2020-11-27;F;111;1;4;922;77988;5218
Hovedstaden;2020-11-27;M;349;0;14;922;78337;5232
Midtjylland;2020-11-27;M;116;3;6;925;78453;5238
Nordjylland;2020-11-27;M;22;0;0;925;78475;5238
Sjælland;2020-11-27;M;74;0;4;925;78549;5242
Syddanmark;2020-11-27;M;102;0;3;925;78651;5245
Hovedstaden;2020-11-28;F;313;0;6;925;78964;5251
Midtjylland;2020-11-28;F;98;0;1;925;79062;5252
Nordjylland;2020-11-28;F;13;0;1;925;79075;5253
Sjælland;2020-11-28;F;67;0;1;925;79142;5254
Syddanmark;2020-11-28;F;66;0;1;925;79208;5255
Hovedstaden;2020-11-28;M;315;1;12;926;79523;5267
Midtjylland;2020-11-28;M;114;1;5;927;79637;5272
Nordjylland;2020-11-28;M;13;0;1;927;79650;5273
Sjælland;2020-11-28;M;79;0;3;927;79729;5276
Syddanmark;2020-11-28;M;73;1;3;928;79802;5279
Hovedstaden;2020-11-29;F;326;0;7;928;80128;5286
Midtjylland;2020-11-29;F;76;0;3;928;80204;5289
Nordjylland;2020-11-29;F;12;0;0;928;80216;5289
Sjælland;2020-11-29;F;63;3;4;931;80279;5293
Syddanmark;2020-11-29;F;70;0;1;931;80349;5294
Hovedstaden;2020-11-29;M;348;3;5;934;80697;5299
Midtjylland;2020-11-29;M;109;1;4;935;80806;5303
Nordjylland;2020-11-29;M;25;0;1;935;80831;5304
Sjælland;2020-11-29;M;80;1;2;936;80911;5306
Syddanmark;2020-11-29;M;64;0;1;936;80975;5307
Hovedstaden;2020-11-30;F;409;5;21;941;81384;5328
Midtjylland;2020-11-30;F;160;2;6;943;81544;5334
Nordjylland;2020-11-30;F;24;0;0;943;81568;5334
Sjælland;2020-11-30;F;110;0;4;943;81678;5338
Syddanmark;2020-11-30;F;94;0;3;943;81772;5341
Hovedstaden;2020-11-30;M;353;4;9;947;82125;5350
Midtjylland;2020-11-30;M;166;3;5;950;82291;5355
Nordjylland;2020-11-30;M;15;0;0;950;82306;5355
Sjælland;2020-11-30;M;96;0;3;950;82402;5358
Syddanmark;2020-11-30;M;105;0;5;950;82507;5363
Hovedstaden;2020-12-01;F;500;2;18;952;83007;5381
Midtjylland;2020-12-01;F;148;1;8;953;83155;5389
Nordjylland;2020-12-01;F;29;0;1;953;83184;5390
Sjælland;2020-12-01;F;101;0;3;953;83285;5393
Syddanmark;2020-12-01;F;93;0;3;953;83378;5396
Hovedstaden;2020-12-01;M;460;1;8;954;83838;5404
Midtjylland;2020-12-01;M;144;1;7;955;83982;5411
Nordjylland;2020-12-01;M;18;0;1;955;84000;5412
Sjælland;2020-12-01;M;106;1;6;956;84106;5418
Syddanmark;2020-12-01;M;115;0;4;956;84221;5422
Hovedstaden;2020-12-02;F;504;1;16;957;84725;5438
Midtjylland;2020-12-02;F;171;0;7;957;84896;5445
Nordjylland;2020-12-02;F;30;0;0;957;84926;5445
Sjælland;2020-12-02;F;146;0;3;957;85072;5448
Syddanmark;2020-12-02;F;85;2;5;959;85157;5453
Hovedstaden;2020-12-02;M;526;2;20;961;85683;5473
Midtjylland;2020-12-02;M;155;0;11;961;85838;5484
Nordjylland;2020-12-02;M;30;0;0;961;85868;5484
Sjælland;2020-12-02;M;122;1;4;962;85990;5488
Syddanmark;2020-12-02;M;111;1;2;963;86101;5490
Hovedstaden;2020-12-03;F;535;2;20;965;86636;5510
Midtjylland;2020-12-03;F;155;0;6;965;86791;5516
Nordjylland;2020-12-03;F;23;0;0;965;86814;5516
Sjælland;2020-12-03;F;126;1;6;966;86940;5522
Syddanmark;2020-12-03;F;132;0;4;966;87072;5526
Hovedstaden;2020-12-03;M;490;2;15;968;87562;5541
Midtjylland;2020-12-03;M;177;3;8;971;87739;5549
Nordjylland;2020-12-03;M;30;0;0;971;87769;5549
Sjælland;2020-12-03;M;123;0;6;971;87892;5555
Syddanmark;2020-12-03;M;117;0;3;971;88009;5558
Hovedstaden;2020-12-04;F;528;2;23;973;88537;5581
Midtjylland;2020-12-04;F;208;1;5;974;88745;5586
Nordjylland;2020-12-04;F;26;0;1;974;88771;5587
Sjælland;2020-12-04;F;139;0;2;974;88910;5589
Syddanmark;2020-12-04;F;106;0;2;974;89016;5591
Hovedstaden;2020-12-04;M;530;4;21;978;89546;5612
Midtjylland;2020-12-04;M;195;1;8;979;89741;5620
Nordjylland;2020-12-04;M;39;0;0;979;89780;5620
Sjælland;2020-12-04;M;125;0;5;979;89905;5625
Syddanmark;2020-12-04;M;122;0;1;979;90027;5626
Hovedstaden;2020-12-05;F;483;6;21;985;90510;5647
Midtjylland;2020-12-05;F;138;3;5;988;90648;5652
Nordjylland;2020-12-05;F;25;0;0;988;90673;5652
Sjælland;2020-12-05;F;150;2;7;990;90823;5659
Syddanmark;2020-12-05;F;75;1;2;991;90898;5661
Hovedstaden;2020-12-05;M;492;5;21;996;91390;5682
Midtjylland;2020-12-05;M;128;0;7;996;91518;5689
Nordjylland;2020-12-05;M;28;1;3;997;91546;5692
Sjælland;2020-12-05;M;117;1;7;998;91663;5699
Syddanmark;2020-12-05;M;80;0;4;998;91743;5703
Hovedstaden;2020-12-06;F;600;2;19;1000;92343;5722
Midtjylland;2020-12-06;F;163;0;5;1000;92506;5727
Nordjylland;2020-12-06;F;42;1;1;1001;92548;5728
Sjælland;2020-12-06;F;136;0;5;1001;92684;5733
Syddanmark;2020-12-06;F;90;0;1;1001;92774;5734
Hovedstaden;2020-12-06;M;513;5;28;1006;93287;5762
Midtjylland;2020-12-06;M;142;0;3;1006;93429;5765
Nordjylland;2020-12-06;M;28;0;0;1006;93457;5765
Sjælland;2020-12-06;M;138;1;9;1007;93595;5774
Syddanmark;2020-12-06;M;124;1;4;1008;93719;5778
Hovedstaden;2020-12-07;F;760;11;36;1019;94479;5814
Midtjylland;2020-12-07;F;230;1;5;1020;94709;5819
Nordjylland;2020-12-07;F;47;0;1;1020;94756;5820
Sjælland;2020-12-07;F;198;0;9;1020;94954;5829
Syddanmark;2020-12-07;F;159;0;4;1020;95113;5833
Hovedstaden;2020-12-07;M;754;8;35;1028;95867;5868
Midtjylland;2020-12-07;M;213;0;5;1028;96080;5873
Nordjylland;2020-12-07;M;58;1;2;1029;96138;5875
Sjælland;2020-12-07;M;184;0;8;1029;96322;5883
Syddanmark;2020-12-07;M;150;1;8;1030;96472;5891
Hovedstaden;2020-12-08;F;862;5;24;1035;97334;5915
Midtjylland;2020-12-08;F;265;0;8;1035;97599;5923
Nordjylland;2020-12-08;F;78;0;3;1035;97677;5926
Sjælland;2020-12-08;F;232;1;9;1036;97909;5935
Syddanmark;2020-12-08;F;156;1;7;1037;98065;5942
Hovedstaden;2020-12-08;M;809;7;31;1044;98874;5973
Midtjylland;2020-12-08;M;254;1;6;1045;99128;5979
Nordjylland;2020-12-08;M;61;0;3;1045;99189;5982
Sjælland;2020-12-08;M;234;1;4;1046;99423;5986
Syddanmark;2020-12-08;M;174;0;2;1046;99597;5988
Hovedstaden;2020-12-09;F;839;2;29;1048;100436;6017
Midtjylland;2020-12-09;F;304;3;4;1051;100740;6021
Nordjylland;2020-12-09;F;66;0;0;1051;100806;6021
Sjælland;2020-12-09;F;228;1;13;1052;101034;6034
Syddanmark;2020-12-09;F;173;0;2;1052;101207;6036
Hovedstaden;2020-12-09;M;857;4;23;1056;102064;6059
Midtjylland;2020-12-09;M;274;1;8;1057;102338;6067
Nordjylland;2020-12-09;M;79;0;1;1057;102417;6068
Sjælland;2020-12-09;M;213;2;9;1059;102630;6077
Syddanmark;2020-12-09;M;160;0;2;1059;102790;6079
Hovedstaden;2020-12-10;F;947;9;32;1068;103737;6111
Midtjylland;2020-12-10;F;321;1;7;1069;104058;6118
Nordjylland;2020-12-10;F;78;0;4;1069;104136;6122
Sjælland;2020-12-10;F;243;1;5;1070;104379;6127
Syddanmark;2020-12-10;F;147;2;5;1072;104526;6132
Hovedstaden;2020-12-10;M;862;8;33;1080;105388;6165
Midtjylland;2020-12-10;M;279;2;4;1082;105667;6169
Nordjylland;2020-12-10;M;88;1;1;1083;105755;6170
Sjælland;2020-12-10;M;184;1;12;1084;105939;6182
Syddanmark;2020-12-10;M;135;0;4;1084;106074;6186
Hovedstaden;2020-12-11;F;840;7;36;1091;106914;6222
Midtjylland;2020-12-11;F;304;0;11;1091;107218;6233
Nordjylland;2020-12-11;F;58;1;0;1092;107276;6233
Sjælland;2020-12-11;F;255;2;10;1094;107531;6243
Syddanmark;2020-12-11;F;166;1;6;1095;107697;6249
Hovedstaden;2020-12-11;M;901;6;43;1101;108598;6292
Midtjylland;2020-12-11;M;279;0;14;1101;108877;6306
Nordjylland;2020-12-11;M;67;0;1;1101;108944;6307
Sjælland;2020-12-11;M;251;1;9;1102;109195;6316
Syddanmark;2020-12-11;M;175;0;5;1102;109370;6321
Hovedstaden;2020-12-12;F;857;3;40;1105;110227;6361
Midtjylland;2020-12-12;F;267;0;4;1105;110494;6365
Nordjylland;2020-12-12;F;76;0;3;1105;110570;6368
Sjælland;2020-12-12;F;225;0;1;1105;110795;6369
Syddanmark;2020-12-12;F;150;0;4;1105;110945;6373
Hovedstaden;2020-12-12;M;828;3;17;1108;111773;6390
Midtjylland;2020-12-12;M;277;1;8;1109;112050;6398
Nordjylland;2020-12-12;M;84;1;4;1110;112134;6402
Sjælland;2020-12-12;M;187;0;8;1110;112321;6410
Syddanmark;2020-12-12;M;138;0;3;1110;112459;6413
Hovedstaden;2020-12-13;F;967;8;43;1118;113426;6456
Midtjylland;2020-12-13;F;245;2;6;1120;113671;6462
Nordjylland;2020-12-13;F;61;0;5;1120;113732;6467
Sjælland;2020-12-13;F;207;0;6;1120;113939;6473
Syddanmark;2020-12-13;F;152;0;1;1120;114091;6474
Hovedstaden;2020-12-13;M;925;7;37;1127;115016;6511
Midtjylland;2020-12-13;M;231;1;9;1128;115247;6520
Nordjylland;2020-12-13;M;62;2;6;1130;115309;6526
Sjælland;2020-12-13;M;169;0;15;1130;115478;6541
Syddanmark;2020-12-13;M;147;1;7;1131;115625;6548
Hovedstaden;2020-12-14;F;1035;7;37;1138;116660;6585
Midtjylland;2020-12-14;F;381;1;10;1139;117041;6595
Nordjylland;2020-12-14;F;94;1;3;1140;117135;6598
Sjælland;2020-12-14;F;321;4;15;1144;117456;6613
Syddanmark;2020-12-14;F;207;0;8;1144;117663;6621
Hovedstaden;2020-12-14;M;981;12;45;1156;118644;6666
Midtjylland;2020-12-14;M;384;1;9;1157;119028;6675
Nordjylland;2020-12-14;M;99;0;5;1157;119127;6680
Sjælland;2020-12-14;M;271;4;15;1161;119398;6695
Syddanmark;2020-12-14;M;216;2;4;1163;119614;6699
Hovedstaden;2020-12-15;F;1114;5;42;1168;120728;6741
Midtjylland;2020-12-15;F;421;2;9;1170;121149;6750
Nordjylland;2020-12-15;F;98;0;2;1170;121247;6752
Sjælland;2020-12-15;F;323;4;13;1174;121570;6765
Syddanmark;2020-12-15;F;267;1;4;1175;121837;6769
Hovedstaden;2020-12-15;M;1014;2;29;1177;122851;6798
Midtjylland;2020-12-15;M;384;4;14;1181;123235;6812
Nordjylland;2020-12-15;M;113;1;1;1182;123348;6813
Sjælland;2020-12-15;M;287;4;19;1186;123635;6832
Syddanmark;2020-12-15;M;276;1;10;1187;123911;6842
Hovedstaden;2020-12-16;F;1191;5;60;1192;125102;6902
Midtjylland;2020-12-16;F;368;0;10;1192;125470;6912
Nordjylland;2020-12-16;F;113;1;2;1193;125583;6914
Sjælland;2020-12-16;F;378;2;15;1195;125961;6929
Syddanmark;2020-12-16;F;258;1;8;1196;126219;6937
Hovedstaden;2020-12-16;M;1022;5;43;1201;127241;6980
Midtjylland;2020-12-16;M;380;2;16;1203;127621;6996
Nordjylland;2020-12-16;M;113;1;7;1204;127734;7003
Sjælland;2020-12-16;M;307;1;18;1205;128041;7021
Syddanmark;2020-12-16;M;264;1;5;1206;128305;7026
Hovedstaden;2020-12-17;F;917;7;41;1213;129222;7067
Midtjylland;2020-12-17;F;312;1;10;1214;129534;7077
Nordjylland;2020-12-17;F;102;0;1;1214;129636;7078
Sjælland;2020-12-17;F;318;3;13;1217;129954;7091
Syddanmark;2020-12-17;F;257;1;6;1218;130211;7097
Hovedstaden;2020-12-17;M;824;10;60;1228;131035;7157
Midtjylland;2020-12-17;M;297;1;13;1229;131332;7170
Nordjylland;2020-12-17;M;100;0;2;1229;131432;7172
Sjælland;2020-12-17;M;254;3;10;1232;131686;7182
Syddanmark;2020-12-17;M;237;0;10;1232;131923;7192
Hovedstaden;2020-12-18;F;764;7;42;1239;132687;7234
Midtjylland;2020-12-18;F;293;0;5;1239;132980;7239
Nordjylland;2020-12-18;F;101;0;1;1239;133081;7240
Sjælland;2020-12-18;F;247;4;11;1243;133328;7251
Syddanmark;2020-12-18;F;184;3;11;1246;133512;7262
Hovedstaden;2020-12-18;M;757;11;40;1257;134269;7302
Midtjylland;2020-12-18;M;255;5;14;1262;134524;7316
Nordjylland;2020-12-18;M;112;0;3;1262;134636;7319
Sjælland;2020-12-18;M;228;5;18;1267;134864;7337
Syddanmark;2020-12-18;M;192;1;5;1268;135056;7342
Hovedstaden;2020-12-19;F;667;7;41;1275;135723;7383
Midtjylland;2020-12-19;F;252;2;11;1277;135975;7394
Nordjylland;2020-12-19;F;113;2;7;1279;136088;7401
Sjælland;2020-12-19;F;181;3;5;1282;136269;7406
Syddanmark;2020-12-19;F;202;1;7;1283;136471;7413
Hovedstaden;2020-12-19;M;611;10;31;1293;137082;7444
Midtjylland;2020-12-19;M;262;3;9;1296;137344;7453
Nordjylland;2020-12-19;M;98;0;4;1296;137442;7457
Sjælland;2020-12-19;M;207;4;14;1300;137649;7471
Syddanmark;2020-12-19;M;163;3;9;1303;137812;7480
Hovedstaden;2020-12-20;F;608;3;27;1306;138420;7507
Midtjylland;2020-12-20;F;205;0;5;1306;138625;7512
Nordjylland;2020-12-20;F;89;0;1;1306;138714;7513
Sjælland;2020-12-20;F;216;6;13;1312;138930;7526
Syddanmark;2020-12-20;F;156;1;6;1313;139086;7532
Hovedstaden;2020-12-20;M;566;8;49;1321;139652;7581
Midtjylland;2020-12-20;M;185;3;9;1324;139837;7590
Nordjylland;2020-12-20;M;80;1;2;1325;139917;7592
Sjælland;2020-12-20;M;183;1;8;1326;140100;7600
Syddanmark;2020-12-20;M;166;5;7;1331;140266;7607
Hovedstaden;2020-12-21;F;817;9;43;1340;141083;7650
Midtjylland;2020-12-21;F;311;1;10;1341;141394;7660
Nordjylland;2020-12-21;F;103;1;3;1342;141497;7663
Sjælland;2020-12-21;F;283;3;15;1345;141780;7678
Syddanmark;2020-12-21;F;238;0;10;1345;142018;7688
Hovedstaden;2020-12-21;M;635;12;42;1357;142653;7730
Midtjylland;2020-12-21;M;203;5;15;1362;142856;7745
Nordjylland;2020-12-21;M;94;1;7;1363;142950;7752
Sjælland;2020-12-21;M;206;0;12;1363;143156;7764
Syddanmark;2020-12-21;M;213;1;10;1364;143369;7774
Hovedstaden;2020-12-22;F;713;7;39;1371;144082;7813
Midtjylland;2020-12-22;F;256;3;13;1374;144338;7826
Nordjylland;2020-12-22;F;128;1;4;1375;144466;7830
Sjælland;2020-12-22;F;256;2;14;1377;144722;7844
Syddanmark;2020-12-22;F;194;3;8;1380;144916;7852
Hovedstaden;2020-12-22;M;632;10;48;1390;145548;7900
Midtjylland;2020-12-22;M;214;6;10;1396;145762;7910
Nordjylland;2020-12-22;M;114;5;8;1401;145876;7918
Sjælland;2020-12-22;M;203;4;14;1405;146079;7932
Syddanmark;2020-12-22;M;161;1;8;1406;146240;7940
Hovedstaden;2020-12-23;F;766;7;32;1413;147006;7972
Midtjylland;2020-12-23;F;268;1;13;1414;147274;7985
Nordjylland;2020-12-23;F;121;1;7;1415;147395;7992
Sjælland;2020-12-23;F;228;3;20;1418;147623;8012
Syddanmark;2020-12-23;F;199;1;7;1419;147822;8019
Hovedstaden;2020-12-23;M;662;8;36;1427;148484;8055
Midtjylland;2020-12-23;M;247;2;12;1429;148731;8067
Nordjylland;2020-12-23;M;134;3;4;1432;148865;8071
Sjælland;2020-12-23;M;215;3;17;1435;149080;8088
Syddanmark;2020-12-23;M;239;0;9;1435;149319;8097
Hovedstaden;2020-12-24;F;371;7;22;1442;149690;8119
Midtjylland;2020-12-24;F;132;1;11;1443;149822;8130
Nordjylland;2020-12-24;F;65;0;4;1443;149887;8134
Sjælland;2020-12-24;F;79;3;4;1446;149966;8138
Syddanmark;2020-12-24;F;111;0;2;1446;150077;8140
Hovedstaden;2020-12-24;M;359;5;32;1451;150436;8172
Midtjylland;2020-12-24;M;116;1;8;1452;150552;8180
Nordjylland;2020-12-24;M;69;0;4;1452;150621;8184
Sjælland;2020-12-24;M;77;3;6;1455;150698;8190
Syddanmark;2020-12-24;M;97;0;2;1455;150795;8192
Hovedstaden;2020-12-25;F;429;9;41;1464;151224;8233
Midtjylland;2020-12-25;F;112;1;4;1465;151336;8237
Nordjylland;2020-12-25;F;65;1;3;1466;151401;8240
Sjælland;2020-12-25;F;122;2;12;1468;151523;8252
Syddanmark;2020-12-25;F;129;0;6;1468;151652;8258
Hovedstaden;2020-12-25;M;377;12;37;1480;152029;8295
Midtjylland;2020-12-25;M;102;3;12;1483;152131;8307
Nordjylland;2020-12-25;M;65;3;3;1486;152196;8310
Sjælland;2020-12-25;M;83;2;10;1488;152279;8320
Syddanmark;2020-12-25;M;104;1;7;1489;152383;8327
Hovedstaden;2020-12-26;F;674;11;35;1500;153057;8362
Midtjylland;2020-12-26;F;230;1;8;1501;153287;8370
Nordjylland;2020-12-26;F;91;0;4;1501;153378;8374
Sjælland;2020-12-26;F;228;1;7;1502;153606;8381
Syddanmark;2020-12-26;F;171;1;6;1503;153777;8387
Hovedstaden;2020-12-26;M;605;11;55;1514;154382;8442
Midtjylland;2020-12-26;M;232;3;12;1517;154614;8454
Nordjylland;2020-12-26;M;87;0;6;1517;154701;8460
Sjælland;2020-12-26;M;218;3;21;1520;154919;8481
Syddanmark;2020-12-26;M;153;2;10;1522;155072;8491
Hovedstaden;2020-12-27;F;545;11;39;1533;155617;8530
Midtjylland;2020-12-27;F;232;3;9;1536;155849;8539
Nordjylland;2020-12-27;F;100;2;6;1538;155949;8545
Sjælland;2020-12-27;F;162;0;2;1538;156111;8547
Syddanmark;2020-12-27;F;155;4;10;1542;156266;8557
Hovedstaden;2020-12-27;M;470;7;31;1549;156736;8588
Midtjylland;2020-12-27;M;184;5;9;1554;156920;8597
Nordjylland;2020-12-27;M;71;1;3;1555;156991;8600
Sjælland;2020-12-27;M;165;6;18;1561;157156;8618
Syddanmark;2020-12-27;M;105;0;9;1561;157261;8627
Hovedstaden;2020-12-28;F;755;15;52;1576;158016;8679
Midtjylland;2020-12-28;F;306;3;16;1579;158322;8695
Nordjylland;2020-12-28;F;138;1;6;1580;158460;8701
Sjælland;2020-12-28;F;295;4;15;1584;158755;8716
Syddanmark;2020-12-28;F;216;4;14;1588;158971;8730
Hovedstaden;2020-12-28;M;536;10;39;1598;159507;8769
Midtjylland;2020-12-28;M;264;5;26;1603;159771;8795
Nordjylland;2020-12-28;M;123;1;1;1604;159894;8796
Sjælland;2020-12-28;M;249;1;22;1605;160143;8818
Syddanmark;2020-12-28;M;184;4;16;1609;160327;8834
Hovedstaden;2020-12-29;F;566;11;49;1620;160893;8883
Midtjylland;2020-12-29;F;281;4;12;1624;161174;8895
Nordjylland;2020-12-29;F;98;3;6;1627;161272;8901
Sjælland;2020-12-29;F;260;1;12;1628;161532;8913
Syddanmark;2020-12-29;F;175;1;4;1629;161707;8917
Hovedstaden;2020-12-29;M;425;11;37;1640;162132;8954
Midtjylland;2020-12-29;M;239;1;16;1641;162371;8970
Nordjylland;2020-12-29;M;89;0;3;1641;162460;8973
Sjælland;2020-12-29;M;182;0;9;1641;162642;8982
Syddanmark;2020-12-29;M;166;2;8;1643;162808;8990
Hovedstaden;2020-12-30;F;618;10;36;1653;163426;9026
Midtjylland;2020-12-30;F;250;2;11;1655;163676;9037
Nordjylland;2020-12-30;F;120;0;5;1655;163796;9042
Sjælland;2020-12-30;F;264;5;12;1660;164060;9054
Syddanmark;2020-12-30;F;200;3;5;1663;164260;9059
Hovedstaden;2020-12-30;M;566;10;42;1673;164826;9101
Midtjylland;2020-12-30;M;230;4;19;1677;165056;9120
Nordjylland;2020-12-30;M;93;1;7;1678;165149;9127
Sjælland;2020-12-30;M;256;7;19;1685;165405;9146
Syddanmark;2020-12-30;M;176;1;4;1686;165581;9150
Hovedstaden;2020-12-31;F;286;6;22;1692;165867;9172
Midtjylland;2020-12-31;F;123;2;2;1694;165990;9174
Nordjylland;2020-12-31;F;62;1;4;1695;166052;9178
Sjælland;2020-12-31;F;85;0;4;1695;166137;9182
Syddanmark;2020-12-31;F;90;1;6;1696;166227;9188
Hovedstaden;2020-12-31;M;279;8;30;1704;166506;9218
Midtjylland;2020-12-31;M;119;0;9;1704;166625;9227
Nordjylland;2020-12-31;M;43;0;3;1704;166668;9230
Sjælland;2020-12-31;M;68;0;9;1704;166736;9239
Syddanmark;2020-12-31;M;78;1;6;1705;166814;9245
Hovedstaden;2021-01-01;F;288;6;22;1711;167102;9267
Midtjylland;2021-01-01;F;129;1;5;1712;167231;9272
Nordjylland;2021-01-01;F;52;0;2;1712;167283;9274
Sjælland;2021-01-01;F;69;1;9;1713;167352;9283
Syddanmark;2021-01-01;F;90;0;4;1713;167442;9287
Hovedstaden;2021-01-01;M;285;6;25;1719;167727;9312
Midtjylland;2021-01-01;M;101;1;6;1720;167828;9318
Nordjylland;2021-01-01;M;42;2;6;1722;167870;9324
Sjælland;2021-01-01;M;70;1;11;1723;167940;9335
Syddanmark;2021-01-01;M;77;2;6;1725;168017;9341
Hovedstaden;2021-01-02;F;436;3;32;1728;168453;9373
Midtjylland;2021-01-02;F;217;2;3;1730;168670;9376
Nordjylland;2021-01-02;F;96;0;2;1730;168766;9378
Sjælland;2021-01-02;F;162;0;12;1730;168928;9390
Syddanmark;2021-01-02;F;136;1;5;1731;169064;9395
Hovedstaden;2021-01-02;M;401;7;26;1738;169465;9421
Midtjylland;2021-01-02;M;222;2;15;1740;169687;9436
Nordjylland;2021-01-02;M;90;2;9;1742;169777;9445
Sjælland;2021-01-02;M;160;8;16;1750;169937;9461
Syddanmark;2021-01-02;M;125;2;9;1752;170062;9470
Hovedstaden;2021-01-03;F;392;2;21;1754;170454;9491
Midtjylland;2021-01-03;F;184;2;10;1756;170638;9501
Nordjylland;2021-01-03;F;110;7;8;1763;170748;9509
Sjælland;2021-01-03;F;114;2;8;1765;170862;9517
Syddanmark;2021-01-03;F;115;1;5;1766;170977;9522
Hovedstaden;2021-01-03;M;322;3;24;1769;171299;9546
Midtjylland;2021-01-03;M;146;0;6;1769;171445;9552
Nordjylland;2021-01-03;M;68;3;6;1772;171513;9558
Sjælland;2021-01-03;M;107;2;11;1774;171620;9569
Syddanmark;2021-01-03;M;112;0;9;1774;171732;9578
Hovedstaden;2021-01-04;F;581;16;31;1790;172313;9609
Midtjylland;2021-01-04;F;245;5;7;1795;172558;9616
Nordjylland;2021-01-04;F;108;2;6;1797;172666;9622
Sjælland;2021-01-04;F;220;1;8;1798;172886;9630
Syddanmark;2021-01-04;F;175;0;7;1798;173061;9637
Hovedstaden;2021-01-04;M;482;12;35;1810;173543;9672
Midtjylland;2021-01-04;M;213;3;11;1813;173756;9683
Nordjylland;2021-01-04;M;102;2;6;1815;173858;9689
Sjælland;2021-01-04;M;179;2;12;1817;174037;9701
Syddanmark;2021-01-04;M;174;1;6;1818;174211;9707
Hovedstaden;2021-01-05;F;448;0;24;1818;174659;9731
Midtjylland;2021-01-05;F;183;4;11;1822;174842;9742
Nordjylland;2021-01-05;F;85;2;4;1824;174927;9746
Sjælland;2021-01-05;F;205;3;10;1827;175132;9756
Syddanmark;2021-01-05;F;157;3;10;1830;175289;9766
Hovedstaden;2021-01-05;M;380;7;22;1837;175669;9788
Midtjylland;2021-01-05;M;133;0;11;1837;175802;9799
Nordjylland;2021-01-05;M;69;0;3;1837;175871;9802
Sjælland;2021-01-05;M;146;3;9;1840;176017;9811
Syddanmark;2021-01-05;M;123;1;11;1841;176140;9822
Hovedstaden;2021-01-06;F;402;9;31;1850;176542;9853
Midtjylland;2021-01-06;F;154;5;12;1855;176696;9865
Nordjylland;2021-01-06;F;90;0;4;1855;176786;9869
Sjælland;2021-01-06;F;143;3;17;1858;176929;9886
Syddanmark;2021-01-06;F;111;0;6;1858;177040;9892
Hovedstaden;2021-01-06;M;314;10;30;1868;177354;9922
Midtjylland;2021-01-06;M;126;3;10;1871;177480;9932
Nordjylland;2021-01-06;M;87;2;2;1873;177567;9934
Sjælland;2021-01-06;M;129;3;10;1876;177696;9944
Syddanmark;2021-01-06;M;101;0;2;1876;177797;9946
Hovedstaden;2021-01-07;F;319;7;19;1883;178116;9965
Midtjylland;2021-01-07;F;190;5;10;1888;178306;9975
Nordjylland;2021-01-07;F;71;1;4;1889;178377;9979
Sjælland;2021-01-07;F;152;3;15;1892;178529;9994
Syddanmark;2021-01-07;F;136;2;8;1894;178665;10002
Hovedstaden;2021-01-07;M;267;3;20;1897;178932;10022
Midtjylland;2021-01-07;M;147;8;16;1905;179079;10038
Nordjylland;2021-01-07;M;74;1;2;1906;179153;10040
Sjælland;2021-01-07;M;96;4;15;1910;179249;10055
Syddanmark;2021-01-07;M;136;3;9;1913;179385;10064
Hovedstaden;2021-01-08;F;338;5;26;1918;179723;10090
Midtjylland;2021-01-08;F;144;1;11;1919;179867;10101
Nordjylland;2021-01-08;F;57;1;2;1920;179924;10103
Sjælland;2021-01-08;F;108;1;5;1921;180032;10108
Syddanmark;2021-01-08;F;119;1;9;1922;180151;10117
Hovedstaden;2021-01-08;M;270;7;22;1929;180421;10139
Midtjylland;2021-01-08;M;110;3;10;1932;180531;10149
Nordjylland;2021-01-08;M;61;2;10;1934;180592;10159
Sjælland;2021-01-08;M;115;2;10;1936;180707;10169
Syddanmark;2021-01-08;M;110;1;6;1937;180817;10175
Hovedstaden;2021-01-09;F;255;3;20;1940;181072;10195
Midtjylland;2021-01-09;F;113;2;3;1942;181185;10198
Nordjylland;2021-01-09;F;51;0;2;1942;181236;10200
Sjælland;2021-01-09;F;113;3;12;1945;181349;10212
Syddanmark;2021-01-09;F;88;3;4;1948;181437;10216
Hovedstaden;2021-01-09;M;228;9;29;1957;181665;10245
Midtjylland;2021-01-09;M;109;3;6;1960;181774;10251
Nordjylland;2021-01-09;M;50;0;3;1960;181824;10254
Sjælland;2021-01-09;M;99;3;14;1963;181923;10268
Syddanmark;2021-01-09;M;86;3;6;1966;182009;10274
Hovedstaden;2021-01-10;F;210;2;17;1968;182219;10291
Midtjylland;2021-01-10;F;100;2;6;1970;182319;10297
Nordjylland;2021-01-10;F;45;0;3;1970;182364;10300
Sjælland;2021-01-10;F;86;3;13;1973;182450;10313
Syddanmark;2021-01-10;F;75;1;7;1974;182525;10320
Hovedstaden;2021-01-10;M;198;7;23;1981;182723;10343
Midtjylland;2021-01-10;M;85;1;7;1982;182808;10350
Nordjylland;2021-01-10;M;36;2;4;1984;182844;10354
Sjælland;2021-01-10;M;81;1;6;1985;182925;10360
Syddanmark;2021-01-10;M;74;1;4;1986;182999;10364
Hovedstaden;2021-01-11;F;367;7;32;1993;183366;10396
Midtjylland;2021-01-11;F;104;1;9;1994;183470;10405
Nordjylland;2021-01-11;F;57;1;1;1995;183527;10406
Sjælland;2021-01-11;F;127;4;11;1999;183654;10417
Syddanmark;2021-01-11;F;116;2;9;2001;183770;10426
Hovedstaden;2021-01-11;M;249;9;19;2010;184019;10445
Midtjylland;2021-01-11;M;93;3;8;2013;184112;10453
Nordjylland;2021-01-11;M;50;0;1;2013;184162;10454
Sjælland;2021-01-11;M;98;1;12;2014;184260;10466
Syddanmark;2021-01-11;M;92;2;10;2016;184352;10476
Hovedstaden;2021-01-12;F;321;10;28;2026;184673;10504
Midtjylland;2021-01-12;F;98;3;10;2029;184771;10514
Nordjylland;2021-01-12;F;54;1;2;2030;184825;10516
Sjælland;2021-01-12;F;124;1;7;2031;184949;10523
Syddanmark;2021-01-12;F;73;0;3;2031;185022;10526
Hovedstaden;2021-01-12;M;269;4;20;2035;185291;10546
Midtjylland;2021-01-12;M;82;2;6;2037;185373;10552
Nordjylland;2021-01-12;M;51;0;3;2037;185424;10555
Sjælland;2021-01-12;M;110;5;10;2042;185534;10565
Syddanmark;2021-01-12;M;79;2;6;2044;185613;10571
Hovedstaden;2021-01-13;F;270;7;25;2051;185883;10596
Midtjylland;2021-01-13;F;102;2;0;2053;185985;10596
Nordjylland;2021-01-13;F;65;2;4;2055;186050;10600
Sjælland;2021-01-13;F;76;2;12;2057;186126;10612
Syddanmark;2021-01-13;F;83;1;1;2058;186209;10613
Hovedstaden;2021-01-13;M;246;3;27;2061;186455;10640
Midtjylland;2021-01-13;M;69;0;4;2061;186524;10644
Nordjylland;2021-01-13;M;55;3;5;2064;186579;10649
Sjælland;2021-01-13;M;82;3;13;2067;186661;10662
Syddanmark;2021-01-13;M;68;0;2;2067;186729;10664
Hovedstaden;2021-01-14;F;223;4;17;2071;186952;10681
Midtjylland;2021-01-14;F;105;1;4;2072;187057;10685
Nordjylland;2021-01-14;F;50;0;2;2072;187107;10687
Sjælland;2021-01-14;F;98;1;7;2073;187205;10694
Syddanmark;2021-01-14;F;86;1;4;2074;187291;10698
Hovedstaden;2021-01-14;M;201;9;25;2083;187492;10723
Midtjylland;2021-01-14;M;82;1;7;2084;187574;10730
Nordjylland;2021-01-14;M;48;0;1;2084;187622;10731
Sjælland;2021-01-14;M;50;1;5;2085;187672;10736
Syddanmark;2021-01-14;M;64;0;2;2085;187736;10738
Hovedstaden;2021-01-15;F;200;2;13;2087;187936;10751
Midtjylland;2021-01-15;F;64;2;6;2089;188000;10757
Nordjylland;2021-01-15;F;35;0;1;2089;188035;10758
Sjælland;2021-01-15;F;67;2;5;2091;188102;10763
Syddanmark;2021-01-15;F;70;0;6;2091;188172;10769
Hovedstaden;2021-01-15;M;192;4;17;2095;188364;10786
Midtjylland;2021-01-15;M;53;2;8;2097;188417;10794
Nordjylland;2021-01-15;M;51;2;7;2099;188468;10801
Sjælland;2021-01-15;M;66;3;11;2102;188534;10812
Syddanmark;2021-01-15;M;58;2;7;2104;188592;10819
Hovedstaden;2021-01-16;F;177;5;12;2109;188769;10831
Midtjylland;2021-01-16;F;35;1;3;2110;188804;10834
Nordjylland;2021-01-16;F;37;0;1;2110;188841;10835
Sjælland;2021-01-16;F;51;1;2;2111;188892;10837
Syddanmark;2021-01-16;F;73;2;10;2113;188965;10847
Hovedstaden;2021-01-16;M;163;3;20;2116;189128;10867
Midtjylland;2021-01-16;M;37;0;3;2116;189165;10870
Nordjylland;2021-01-16;M;37;2;5;2118;189202;10875
Sjælland;2021-01-16;M;55;0;4;2118;189257;10879
Syddanmark;2021-01-16;M;54;0;6;2118;189311;10885
Hovedstaden;2021-01-17;F;171;2;16;2120;189482;10901
Midtjylland;2021-01-17;F;43;0;2;2120;189525;10903
Nordjylland;2021-01-17;F;29;2;2;2122;189554;10905
Sjælland;2021-01-17;F;63;0;9;2122;189617;10914
Syddanmark;2021-01-17;F;49;1;2;2123;189666;10916
Hovedstaden;2021-01-17;M;150;3;18;2126;189816;10934
Midtjylland;2021-01-17;M;35;0;1;2126;189851;10935
Nordjylland;2021-01-17;M;36;2;4;2128;189887;10939
Sjælland;2021-01-17;M;52;1;7;2129;189939;10946
Syddanmark;2021-01-17;M;49;0;4;2129;189988;10950
Hovedstaden;2021-01-18;F;238;6;24;2135;190226;10974
Midtjylland;2021-01-18;F;65;1;3;2136;190291;10977
Nordjylland;2021-01-18;F;43;0;4;2136;190334;10981
Sjælland;2021-01-18;F;78;2;6;2138;190412;10987
Syddanmark;2021-01-18;F;77;2;6;2140;190489;10993
Hovedstaden;2021-01-18;M;207;8;37;2148;190696;11030
Midtjylland;2021-01-18;M;55;1;5;2149;190751;11035
Nordjylland;2021-01-18;M;31;3;4;2152;190782;11039
Sjælland;2021-01-18;M;62;1;12;2153;190844;11051
Syddanmark;2021-01-18;M;75;0;3;2153;190919;11054
Hovedstaden;2021-01-19;F;188;2;18;2155;191107;11072
Midtjylland;2021-01-19;F;65;1;3;2156;191172;11075
Nordjylland;2021-01-19;F;44;1;6;2157;191216;11081
Sjælland;2021-01-19;F;84;1;6;2158;191300;11087
Syddanmark;2021-01-19;F;80;3;3;2161;191380;11090
Hovedstaden;2021-01-19;M;174;7;25;2168;191554;11115
Midtjylland;2021-01-19;M;47;2;7;2170;191601;11122
Nordjylland;2021-01-19;M;50;3;7;2173;191651;11129
Sjælland;2021-01-19;M;80;1;10;2174;191731;11139
Syddanmark;2021-01-19;M;102;3;7;2177;191833;11146
Hovedstaden;2021-01-20;F;164;3;10;2180;191997;11156
Midtjylland;2021-01-20;F;60;1;2;2181;192057;11158
Nordjylland;2021-01-20;F;41;2;5;2183;192098;11163
Sjælland;2021-01-20;F;71;1;7;2184;192169;11170
Syddanmark;2021-01-20;F;58;1;5;2185;192227;11175
Hovedstaden;2021-01-20;M;153;3;10;2188;192380;11185
Midtjylland;2021-01-20;M;51;1;9;2189;192431;11194
Nordjylland;2021-01-20;M;39;0;5;2189;192470;11199
Sjælland;2021-01-20;M;78;0;4;2189;192548;11203
Syddanmark;2021-01-20;M;61;0;5;2189;192609;11208
Hovedstaden;2021-01-21;F;192;5;19;2194;192801;11227
Midtjylland;2021-01-21;F;63;1;4;2195;192864;11231
Nordjylland;2021-01-21;F;46;0;3;2195;192910;11234
Sjælland;2021-01-21;F;75;0;5;2195;192985;11239
Syddanmark;2021-01-21;F;58;2;6;2197;193043;11245
Hovedstaden;2021-01-21;M;187;5;24;2202;193230;11269
Midtjylland;2021-01-21;M;57;0;5;2202;193287;11274
Nordjylland;2021-01-21;M;29;0;2;2202;193316;11276
Sjælland;2021-01-21;M;71;0;11;2202;193387;11287
Syddanmark;2021-01-21;M;80;2;5;2204;193467;11292
Hovedstaden;2021-01-22;F;150;5;8;2209;193617;11300
Midtjylland;2021-01-22;F;51;1;4;2210;193668;11304
Nordjylland;2021-01-22;F;41;1;3;2211;193709;11307
Sjælland;2021-01-22;F;74;2;9;2213;193783;11316
Syddanmark;2021-01-22;F;53;1;3;2214;193836;11319
Hovedstaden;2021-01-22;M;139;3;11;2217;193975;11330
Midtjylland;2021-01-22;M;44;1;2;2218;194019;11332
Nordjylland;2021-01-22;M;43;3;5;2221;194062;11337
Sjælland;2021-01-22;M;56;1;6;2222;194118;11343
Syddanmark;2021-01-22;M;64;0;2;2222;194182;11345
Hovedstaden;2021-01-23;F;137;2;12;2224;194319;11357
Midtjylland;2021-01-23;F;42;1;2;2225;194361;11359
Nordjylland;2021-01-23;F;21;0;1;2225;194382;11360
Sjælland;2021-01-23;F;54;2;5;2227;194436;11365
Syddanmark;2021-01-23;F;45;0;3;2227;194481;11368
Hovedstaden;2021-01-23;M;120;2;13;2229;194601;11381
Midtjylland;2021-01-23;M;42;0;5;2229;194643;11386
Nordjylland;2021-01-23;M;24;1;3;2230;194667;11389
Sjælland;2021-01-23;M;46;1;4;2231;194713;11393
Syddanmark;2021-01-23;M;60;1;3;2232;194773;11396
Hovedstaden;2021-01-24;F;125;0;12;2232;194898;11408
Midtjylland;2021-01-24;F;32;1;0;2233;194930;11408
Nordjylland;2021-01-24;F;28;1;4;2234;194958;11412
Sjælland;2021-01-24;F;42;3;4;2237;195000;11416
Syddanmark;2021-01-24;F;49;0;2;2237;195049;11418
Hovedstaden;2021-01-24;M;121;2;11;2239;195170;11429
Midtjylland;2021-01-24;M;23;1;2;2240;195193;11431
Nordjylland;2021-01-24;M;29;0;1;2240;195222;11432
Sjælland;2021-01-24;M;42;0;4;2240;195264;11436
Syddanmark;2021-01-24;M;23;0;1;2240;195287;11437
Hovedstaden;2021-01-25;F;160;5;11;2245;195447;11448
Midtjylland;2021-01-25;F;43;0;5;2245;195490;11453
Nordjylland;2021-01-25;F;29;0;2;2245;195519;11455
Sjælland;2021-01-25;F;68;1;8;2246;195587;11463
Syddanmark;2021-01-25;F;50;0;4;2246;195637;11467
Hovedstaden;2021-01-25;M;172;3;16;2249;195809;11483
Midtjylland;2021-01-25;M;41;0;2;2249;195850;11485
Nordjylland;2021-01-25;M;23;0;2;2249;195873;11487
Sjælland;2021-01-25;M;63;0;6;2249;195936;11493
Syddanmark;2021-01-25;M;73;0;6;2249;196009;11499
Hovedstaden;2021-01-26;F;143;1;8;2250;196152;11507
Midtjylland;2021-01-26;F;48;0;3;2250;196200;11510
Nordjylland;2021-01-26;F;34;0;0;2250;196234;11510
Sjælland;2021-01-26;F;68;0;5;2250;196302;11515
Syddanmark;2021-01-26;F;59;0;1;2250;196361;11516
Hovedstaden;2021-01-26;M;137;2;13;2252;196498;11529
Midtjylland;2021-01-26;M;47;3;4;2255;196545;11533
Nordjylland;2021-01-26;M;33;0;4;2255;196578;11537
Sjælland;2021-01-26;M;67;1;6;2256;196645;11543
Syddanmark;2021-01-26;M;47;0;0;2256;196692;11543
Hovedstaden;2021-01-27;F;139;1;12;2257;196831;11555
Midtjylland;2021-01-27;F;36;0;1;2257;196867;11556
Nordjylland;2021-01-27;F;13;0;1;2257;196880;11557
Sjælland;2021-01-27;F;50;1;3;2258;196930;11560
Syddanmark;2021-01-27;F;39;1;3;2259;196969;11563
Hovedstaden;2021-01-27;M;111;4;11;2263;197080;11574
Midtjylland;2021-01-27;M;29;1;3;2264;197109;11577
Nordjylland;2021-01-27;M;23;0;2;2264;197132;11579
Sjælland;2021-01-27;M;52;3;8;2267;197184;11587
Syddanmark;2021-01-27;M;40;0;3;2267;197224;11590
Hovedstaden;2021-01-28;F;131;2;11;2269;197355;11601
Midtjylland;2021-01-28;F;44;1;4;2270;197399;11605
Nordjylland;2021-01-28;F;23;0;0;2270;197422;11605
Sjælland;2021-01-28;F;50;0;5;2270;197472;11610
Syddanmark;2021-01-28;F;31;0;2;2270;197503;11612
Hovedstaden;2021-01-28;M;106;4;9;2274;197609;11621
Midtjylland;2021-01-28;M;28;0;1;2274;197637;11622
Nordjylland;2021-01-28;M;17;2;2;2276;197654;11624
Sjælland;2021-01-28;M;33;0;4;2276;197687;11628
Syddanmark;2021-01-28;M;39;1;1;2277;197726;11629
Hovedstaden;2021-01-29;F;99;4;6;2281;197825;11635
Midtjylland;2021-01-29;F;20;0;2;2281;197845;11637
Nordjylland;2021-01-29;F;17;0;2;2281;197862;11639
Sjælland;2021-01-29;F;39;1;5;2282;197901;11644
Syddanmark;2021-01-29;F;35;0;0;2282;197936;11644
Hovedstaden;2021-01-29;M;84;3;8;2285;198020;11652
Midtjylland;2021-01-29;M;26;1;3;2286;198046;11655
Nordjylland;2021-01-29;M;14;0;3;2286;198060;11658
Sjælland;2021-01-29;M;25;0;4;2286;198085;11662
Syddanmark;2021-01-29;M;47;1;0;2287;198132;11662
Hovedstaden;2021-01-30;F;76;4;8;2291;198208;11670
Midtjylland;2021-01-30;F;13;0;1;2291;198221;11671
Nordjylland;2021-01-30;F;12;0;1;2291;198233;11672
Sjælland;2021-01-30;F;31;0;3;2291;198264;11675
Syddanmark;2021-01-30;F;36;0;2;2291;198300;11677
Hovedstaden;2021-01-30;M;92;0;7;2291;198392;11684
Midtjylland;2021-01-30;M;26;0;0;2291;198418;11684
Nordjylland;2021-01-30;M;16;1;1;2292;198434;11685
Sjælland;2021-01-30;M;25;0;2;2292;198459;11687
Syddanmark;2021-01-30;M;34;0;1;2292;198493;11688
Hovedstaden;2021-01-31;F;89;3;7;2295;198582;11695
Midtjylland;2021-01-31;F;25;1;2;2296;198607;11697
Nordjylland;2021-01-31;F;12;0;0;2296;198619;11697
Sjælland;2021-01-31;F;25;0;3;2296;198644;11700
Syddanmark;2021-01-31;F;30;1;2;2297;198674;11702
Hovedstaden;2021-01-31;M;94;0;10;2297;198768;11712
Midtjylland;2021-01-31;M;20;0;3;2297;198788;11715
Nordjylland;2021-01-31;M;20;0;1;2297;198808;11716
Sjælland;2021-01-31;M;37;0;4;2297;198845;11720
Syddanmark;2021-01-31;M;37;0;4;2297;198882;11724
Hovedstaden;2021-02-01;F;100;1;8;2298;198982;11732
Midtjylland;2021-02-01;F;36;0;3;2298;199018;11735
Nordjylland;2021-02-01;F;24;0;2;2298;199042;11737
Sjælland;2021-02-01;F;52;0;3;2298;199094;11740
Syddanmark;2021-02-01;F;52;1;5;2299;199146;11745
Hovedstaden;2021-02-01;M;113;5;14;2304;199259;11759
Midtjylland;2021-02-01;M;29;0;3;2304;199288;11762
Nordjylland;2021-02-01;M;23;1;4;2305;199311;11766
Sjælland;2021-02-01;M;36;1;4;2306;199347;11770
Syddanmark;2021-02-01;M;41;1;4;2307;199388;11774
Hovedstaden;2021-02-02;F;96;0;9;2307;199484;11783
Midtjylland;2021-02-02;F;34;0;1;2307;199518;11784
Nordjylland;2021-02-02;F;22;0;1;2307;199540;11785
Sjælland;2021-02-02;F;43;0;4;2307;199583;11789
Syddanmark;2021-02-02;F;51;3;8;2310;199634;11797
Hovedstaden;2021-02-02;M;114;4;12;2314;199748;11809
Midtjylland;2021-02-02;M;29;0;2;2314;199777;11811
Nordjylland;2021-02-02;M;23;1;2;2315;199800;11813
Sjælland;2021-02-02;M;34;0;2;2315;199834;11815
Syddanmark;2021-02-02;M;42;1;5;2316;199876;11820
Hovedstaden;2021-02-03;F;76;0;4;2316;199952;11824
Midtjylland;2021-02-03;F;21;0;1;2316;199973;11825
Nordjylland;2021-02-03;F;23;1;1;2317;199996;11826
Sjælland;2021-02-03;F;41;1;4;2318;200037;11830
Syddanmark;2021-02-03;F;53;1;2;2319;200090;11832
Hovedstaden;2021-02-03;M;83;0;5;2319;200173;11837
Midtjylland;2021-02-03;M;34;0;1;2319;200207;11838
Nordjylland;2021-02-03;M;19;0;3;2319;200226;11841
Sjælland;2021-02-03;M;31;1;3;2320;200257;11844
Syddanmark;2021-02-03;M;47;1;4;2321;200304;11848
Hovedstaden;2021-02-04;F;94;2;8;2323;200398;11856
Midtjylland;2021-02-04;F;36;0;0;2323;200434;11856
Nordjylland;2021-02-04;F;17;1;2;2324;200451;11858
Sjælland;2021-02-04;F;30;1;2;2325;200481;11860
Syddanmark;2021-02-04;F;34;0;2;2325;200515;11862
Hovedstaden;2021-02-04;M;103;0;11;2325;200618;11873
Midtjylland;2021-02-04;M;32;0;0;2325;200650;11873
Nordjylland;2021-02-04;M;13;0;1;2325;200663;11874
Sjælland;2021-02-04;M;45;1;7;2326;200708;11881
Syddanmark;2021-02-04;M;35;0;0;2326;200743;11881
Hovedstaden;2021-02-05;F;89;0;6;2326;200832;11887
Midtjylland;2021-02-05;F;34;0;1;2326;200866;11888
Nordjylland;2021-02-05;F;21;0;1;2326;200887;11889
Sjælland;2021-02-05;F;25;2;4;2328;200912;11893
Syddanmark;2021-02-05;F;32;1;0;2329;200944;11893
Hovedstaden;2021-02-05;M;83;3;11;2332;201027;11904
Midtjylland;2021-02-05;M;32;0;2;2332;201059;11906
Nordjylland;2021-02-05;M;12;0;1;2332;201071;11907
Sjælland;2021-02-05;M;36;1;6;2333;201107;11913
Syddanmark;2021-02-05;M;43;1;1;2334;201150;11914
Hovedstaden;2021-02-06;F;98;0;9;2334;201248;11923
Midtjylland;2021-02-06;F;30;0;3;2334;201278;11926
Nordjylland;2021-02-06;F;19;1;4;2335;201297;11930
Sjælland;2021-02-06;F;36;0;2;2335;201333;11932
Syddanmark;2021-02-06;F;44;0;2;2335;201377;11934
Hovedstaden;2021-02-06;M;72;0;2;2335;201449;11936
Midtjylland;2021-02-06;M;41;0;3;2335;201490;11939
Nordjylland;2021-02-06;M;11;0;1;2335;201501;11940
Sjælland;2021-02-06;M;31;1;3;2336;201532;11943
Syddanmark;2021-02-06;M;52;1;3;2337;201584;11946
Hovedstaden;2021-02-07;F;101;6;14;2343;201685;11960
Midtjylland;2021-02-07;F;33;0;1;2343;201718;11961
Nordjylland;2021-02-07;F;20;0;1;2343;201738;11962
Sjælland;2021-02-07;F;26;0;3;2343;201764;11965
Syddanmark;2021-02-07;F;35;1;2;2344;201799;11967
Hovedstaden;2021-02-07;M;70;2;8;2346;201869;11975
Midtjylland;2021-02-07;M;44;0;2;2346;201913;11977
Nordjylland;2021-02-07;M;13;0;2;2346;201926;11979
Sjælland;2021-02-07;M;20;0;0;2346;201946;11979
Syddanmark;2021-02-07;M;27;1;0;2347;201973;11979
Hovedstaden;2021-02-08;F;92;1;12;2348;202065;11991
Midtjylland;2021-02-08;F;27;0;1;2348;202092;11992
Nordjylland;2021-02-08;F;25;0;1;2348;202117;11993
Sjælland;2021-02-08;F;55;0;8;2348;202172;12001
Syddanmark;2021-02-08;F;41;0;6;2348;202213;12007
Hovedstaden;2021-02-08;M;72;1;5;2349;202285;12012
Midtjylland;2021-02-08;M;39;0;2;2349;202324;12014
Nordjylland;2021-02-08;M;13;1;3;2350;202337;12017
Sjælland;2021-02-08;M;48;1;6;2351;202385;12023
Syddanmark;2021-02-08;M;29;0;2;2351;202414;12025
Hovedstaden;2021-02-09;F;90;2;11;2353;202504;12036
Midtjylland;2021-02-09;F;25;0;0;2353;202529;12036
Nordjylland;2021-02-09;F;22;0;2;2353;202551;12038
Sjælland;2021-02-09;F;36;0;3;2353;202587;12041
Syddanmark;2021-02-09;F;45;1;3;2354;202632;12044
Hovedstaden;2021-02-09;M;88;0;5;2354;202720;12049
Midtjylland;2021-02-09;M;47;0;1;2354;202767;12050
Nordjylland;2021-02-09;M;15;0;3;2354;202782;12053
Sjælland;2021-02-09;M;37;0;5;2354;202819;12058
Syddanmark;2021-02-09;M;53;1;3;2355;202872;12061
Hovedstaden;2021-02-10;F;83;0;7;2355;202955;12068
Midtjylland;2021-02-10;F;43;2;3;2357;202998;12071
Nordjylland;2021-02-10;F;21;0;3;2357;203019;12074
Sjælland;2021-02-10;F;36;0;4;2357;203055;12078
Syddanmark;2021-02-10;F;36;0;1;2357;203091;12079
Hovedstaden;2021-02-10;M;95;1;6;2358;203186;12085
Midtjylland;2021-02-10;M;44;0;2;2358;203230;12087
Nordjylland;2021-02-10;M;23;0;3;2358;203253;12090
Sjælland;2021-02-10;M;26;0;2;2358;203279;12092
Syddanmark;2021-02-10;M;40;1;1;2359;203319;12093
Hovedstaden;2021-02-11;F;84;2;2;2361;203403;12095
Midtjylland;2021-02-11;F;33;0;1;2361;203436;12096
Nordjylland;2021-02-11;F;12;0;0;2361;203448;12096
Sjælland;2021-02-11;F;43;0;2;2361;203491;12098
Syddanmark;2021-02-11;F;38;0;3;2361;203529;12101
Hovedstaden;2021-02-11;M;66;1;4;2362;203595;12105
Midtjylland;2021-02-11;M;27;0;2;2362;203622;12107
Nordjylland;2021-02-11;M;9;1;1;2363;203631;12108
Sjælland;2021-02-11;M;39;1;5;2364;203670;12113
Syddanmark;2021-02-11;M;25;0;2;2364;203695;12115
Hovedstaden;2021-02-12;F;68;1;5;2365;203763;12120
Midtjylland;2021-02-12;F;20;0;1;2365;203783;12121
Nordjylland;2021-02-12;F;18;0;0;2365;203801;12121
Sjælland;2021-02-12;F;26;0;2;2365;203827;12123
Syddanmark;2021-02-12;F;20;0;0;2365;203847;12123
Hovedstaden;2021-02-12;M;77;0;8;2365;203924;12131
Midtjylland;2021-02-12;M;20;0;2;2365;203944;12133
Nordjylland;2021-02-12;M;16;0;1;2365;203960;12134
Sjælland;2021-02-12;M;27;0;2;2365;203987;12136
Syddanmark;2021-02-12;M;25;0;1;2365;204012;12137
Hovedstaden;2021-02-13;F;62;0;3;2365;204074;12140
Midtjylland;2021-02-13;F;25;0;3;2365;204099;12143
Nordjylland;2021-02-13;F;16;0;3;2365;204115;12146
Sjælland;2021-02-13;F;19;0;1;2365;204134;12147
Syddanmark;2021-02-13;F;42;0;3;2365;204176;12150
Hovedstaden;2021-02-13;M;64;1;5;2366;204240;12155
Midtjylland;2021-02-13;M;31;1;0;2367;204271;12155
Nordjylland;2021-02-13;M;15;0;0;2367;204286;12155
Sjælland;2021-02-13;M;12;0;0;2367;204298;12155
Syddanmark;2021-02-13;M;46;0;3;2367;204344;12158
Hovedstaden;2021-02-14;F;59;0;3;2367;204403;12161
Midtjylland;2021-02-14;F;18;0;2;2367;204421;12163
Nordjylland;2021-02-14;F;15;0;2;2367;204436;12165
Sjælland;2021-02-14;F;25;0;2;2367;204461;12167
Syddanmark;2021-02-14;F;48;0;1;2367;204509;12168
Hovedstaden;2021-02-14;M;67;1;3;2368;204576;12171
Midtjylland;2021-02-14;M;26;0;1;2368;204602;12172
Nordjylland;2021-02-14;M;19;0;0;2368;204621;12172
Sjælland;2021-02-14;M;21;1;2;2369;204642;12174
Syddanmark;2021-02-14;M;43;0;3;2369;204685;12177
Hovedstaden;2021-02-15;F;84;0;3;2369;204769;12180
Midtjylland;2021-02-15;F;34;0;1;2369;204803;12181
Nordjylland;2021-02-15;F;22;0;2;2369;204825;12183
Sjælland;2021-02-15;F;27;0;1;2369;204852;12184
Syddanmark;2021-02-15;F;51;0;2;2369;204903;12186
Hovedstaden;2021-02-15;M;79;1;7;2370;204982;12193
Midtjylland;2021-02-15;M;29;2;2;2372;205011;12195
Nordjylland;2021-02-15;M;11;0;1;2372;205022;12196
Sjælland;2021-02-15;M;23;0;3;2372;205045;12199
Syddanmark;2021-02-15;M;45;0;6;2372;205090;12205
Hovedstaden;2021-02-16;F;86;0;5;2372;205176;12210
Midtjylland;2021-02-16;F;37;0;0;2372;205213;12210
Nordjylland;2021-02-16;F;11;0;0;2372;205224;12210
Sjælland;2021-02-16;F;31;0;3;2372;205255;12213
Syddanmark;2021-02-16;F;89;0;4;2372;205344;12217
Hovedstaden;2021-02-16;M;84;1;7;2373;205428;12224
Midtjylland;2021-02-16;M;49;0;2;2373;205477;12226
Nordjylland;2021-02-16;M;10;0;0;2373;205487;12226
Sjælland;2021-02-16;M;33;0;3;2373;205520;12229
Syddanmark;2021-02-16;M;97;0;4;2373;205617;12233
Hovedstaden;2021-02-17;F;93;0;4;2373;205710;12237
Midtjylland;2021-02-17;F;34;0;1;2373;205744;12238
Nordjylland;2021-02-17;F;11;0;2;2373;205755;12240
Sjælland;2021-02-17;F;20;0;0;2373;205775;12240
Syddanmark;2021-02-17;F;84;0;2;2373;205859;12242
Hovedstaden;2021-02-17;M;93;1;8;2374;205952;12250
Midtjylland;2021-02-17;M;43;0;5;2374;205995;12255
Nordjylland;2021-02-17;M;19;0;0;2374;206014;12255
Sjælland;2021-02-17;M;28;0;4;2374;206042;12259
Syddanmark;2021-02-17;M;83;0;5;2374;206125;12264
Hovedstaden;2021-02-18;F;75;0;2;2374;206200;12266
Midtjylland;2021-02-18;F;36;0;0;2374;206236;12266
Nordjylland;2021-02-18;F;37;0;2;2374;206273;12268
Sjælland;2021-02-18;F;31;0;3;2374;206304;12271
Syddanmark;2021-02-18;F;81;0;3;2374;206385;12274
Hovedstaden;2021-02-18;M;71;1;6;2375;206456;12280
Midtjylland;2021-02-18;M;54;0;6;2375;206510;12286
Nordjylland;2021-02-18;M;37;0;3;2375;206547;12289
Sjælland;2021-02-18;M;39;1;6;2376;206586;12295
Syddanmark;2021-02-18;M;88;0;4;2376;206674;12299
Hovedstaden;2021-02-19;F;90;3;7;2379;206764;12306
Midtjylland;2021-02-19;F;28;0;1;2379;206792;12307
Nordjylland;2021-02-19;F;6;0;1;2379;206798;12308
Sjælland;2021-02-19;F;40;0;2;2379;206838;12310
Syddanmark;2021-02-19;F;57;0;4;2379;206895;12314
Hovedstaden;2021-02-19;M;97;0;9;2379;206992;12323
Midtjylland;2021-02-19;M;23;0;0;2379;207015;12323
Nordjylland;2021-02-19;M;20;0;3;2379;207035;12326
Sjælland;2021-02-19;M;37;0;4;2379;207072;12330
Syddanmark;2021-02-19;M;68;0;2;2379;207140;12332
Hovedstaden;2021-02-20;F;75;1;8;2380;207215;12340
Midtjylland;2021-02-20;F;32;0;2;2380;207247;12342
Nordjylland;2021-02-20;F;15;0;0;2380;207262;12342
Sjælland;2021-02-20;F;28;0;0;2380;207290;12342
Syddanmark;2021-02-20;F;53;0;2;2380;207343;12344
Hovedstaden;2021-02-20;M;82;0;10;2380;207425;12354
Midtjylland;2021-02-20;M;33;0;1;2380;207458;12355
Nordjylland;2021-02-20;M;11;0;0;2380;207469;12355
Sjælland;2021-02-20;M;33;1;1;2381;207502;12356
Syddanmark;2021-02-20;M;71;0;3;2381;207573;12359
Hovedstaden;2021-02-21;F;72;0;6;2381;207645;12365
Midtjylland;2021-02-21;F;40;0;0;2381;207685;12365
Nordjylland;2021-02-21;F;9;0;1;2381;207694;12366
Sjælland;2021-02-21;F;22;0;2;2381;207716;12368
Syddanmark;2021-02-21;F;84;0;5;2381;207800;12373
Hovedstaden;2021-02-21;M;91;0;7;2381;207891;12380
Midtjylland;2021-02-21;M;40;0;2;2381;207931;12382
Nordjylland;2021-02-21;M;12;0;1;2381;207943;12383
Sjælland;2021-02-21;M;37;0;3;2381;207980;12386
Syddanmark;2021-02-21;M;67;0;4;2381;208047;12390
Hovedstaden;2021-02-22;F;99;0;8;2381;208146;12398
Midtjylland;2021-02-22;F;44;0;2;2381;208190;12400
Nordjylland;2021-02-22;F;21;0;0;2381;208211;12400
Sjælland;2021-02-22;F;51;1;4;2382;208262;12404
Syddanmark;2021-02-22;F;93;0;4;2382;208355;12408
Hovedstaden;2021-02-22;M;104;0;4;2382;208459;12412
Midtjylland;2021-02-22;M;38;0;0;2382;208497;12412
Nordjylland;2021-02-22;M;19;0;2;2382;208516;12414
Sjælland;2021-02-22;M;43;0;5;2382;208559;12419
Syddanmark;2021-02-22;M;82;0;2;2382;208641;12421
Hovedstaden;2021-02-23;F;135;0;6;2382;208776;12427
Midtjylland;2021-02-23;F;23;1;1;2383;208799;12428
Nordjylland;2021-02-23;F;25;1;2;2384;208824;12430
Sjælland;2021-02-23;F;48;0;3;2384;208872;12433
Syddanmark;2021-02-23;F;73;0;5;2384;208945;12438
Hovedstaden;2021-02-23;M;123;0;9;2384;209068;12447
Midtjylland;2021-02-23;M;43;0;4;2384;209111;12451
Nordjylland;2021-02-23;M;17;0;1;2384;209128;12452
Sjælland;2021-02-23;M;52;1;6;2385;209180;12458
Syddanmark;2021-02-23;M;75;0;5;2385;209255;12463
Hovedstaden;2021-02-24;F;121;3;11;2388;209376;12474
Midtjylland;2021-02-24;F;33;0;0;2388;209409;12474
Nordjylland;2021-02-24;F;13;0;2;2388;209422;12476
Sjælland;2021-02-24;F;49;0;1;2388;209471;12477
Syddanmark;2021-02-24;F;60;0;5;2388;209531;12482
Hovedstaden;2021-02-24;M;112;0;10;2388;209643;12492
Midtjylland;2021-02-24;M;29;0;0;2388;209672;12492
Nordjylland;2021-02-24;M;12;0;1;2388;209684;12493
Sjælland;2021-02-24;M;40;0;1;2388;209724;12494
Syddanmark;2021-02-24;M;71;0;6;2388;209795;12500
Hovedstaden;2021-02-25;F;114;0;7;2388;209909;12507
Midtjylland;2021-02-25;F;31;0;1;2388;209940;12508
Nordjylland;2021-02-25;F;16;0;0;2388;209956;12508
Sjælland;2021-02-25;F;61;0;7;2388;210017;12515
Syddanmark;2021-02-25;F;55;0;6;2388;210072;12521
Hovedstaden;2021-02-25;M;119;1;5;2389;210191;12526
Midtjylland;2021-02-25;M;33;0;4;2389;210224;12530
Nordjylland;2021-02-25;M;13;0;0;2389;210237;12530
Sjælland;2021-02-25;M;43;0;2;2389;210280;12532
Syddanmark;2021-02-25;M;62;0;1;2389;210342;12533
Hovedstaden;2021-02-26;F;121;0;8;2389;210463;12541
Midtjylland;2021-02-26;F;19;0;0;2389;210482;12541
Nordjylland;2021-02-26;F;8;0;0;2389;210490;12541
Sjælland;2021-02-26;F;34;0;1;2389;210524;12542
Syddanmark;2021-02-26;F;65;0;3;2389;210589;12545
Hovedstaden;2021-02-26;M;110;0;4;2389;210699;12549
Midtjylland;2021-02-26;M;26;0;3;2389;210725;12552
Nordjylland;2021-02-26;M;12;0;0;2389;210737;12552
Sjælland;2021-02-26;M;32;1;5;2390;210769;12557
Syddanmark;2021-02-26;M;66;0;4;2390;210835;12561
Hovedstaden;2021-02-27;F;106;1;4;2391;210941;12565
Midtjylland;2021-02-27;F;25;0;2;2391;210966;12567
Nordjylland;2021-02-27;F;12;0;0;2391;210978;12567
Sjælland;2021-02-27;F;31;0;1;2391;211009;12568
Syddanmark;2021-02-27;F;46;1;2;2392;211055;12570
Hovedstaden;2021-02-27;M;98;0;5;2392;211153;12575
Midtjylland;2021-02-27;M;25;0;1;2392;211178;12576
Nordjylland;2021-02-27;M;8;0;0;2392;211186;12576
Sjælland;2021-02-27;M;31;0;4;2392;211217;12580
Syddanmark;2021-02-27;M;43;0;4;2392;211260;12584
Hovedstaden;2021-02-28;F;123;0;6;2392;211383;12590
Midtjylland;2021-02-28;F;27;0;2;2392;211410;12592
Nordjylland;2021-02-28;F;13;0;0;2392;211423;12592
Sjælland;2021-02-28;F;21;0;1;2392;211444;12593
Syddanmark;2021-02-28;F;58;1;5;2393;211502;12598
Hovedstaden;2021-02-28;M;119;0;4;2393;211621;12602
Midtjylland;2021-02-28;M;20;0;1;2393;211641;12603
Nordjylland;2021-02-28;M;13;0;1;2393;211654;12604
Sjælland;2021-02-28;M;28;0;2;2393;211682;12606
Syddanmark;2021-02-28;M;57;0;2;2393;211739;12608
Hovedstaden;2021-03-01;F;136;0;4;2393;211875;12612
Midtjylland;2021-03-01;F;31;0;1;2393;211906;12613
Nordjylland;2021-03-01;F;18;0;0;2393;211924;12613
Sjælland;2021-03-01;F;56;0;4;2393;211980;12617
Syddanmark;2021-03-01;F;63;0;7;2393;212043;12624
Hovedstaden;2021-03-01;M;131;0;5;2393;212174;12629
Midtjylland;2021-03-01;M;33;0;0;2393;212207;12629
Nordjylland;2021-03-01;M;16;0;1;2393;212223;12630
Sjælland;2021-03-01;M;50;2;5;2395;212273;12635
Syddanmark;2021-03-01;M;63;1;2;2396;212336;12637
Hovedstaden;2021-03-02;F;124;2;6;2398;212460;12643
Midtjylland;2021-03-02;F;40;0;1;2398;212500;12644
Nordjylland;2021-03-02;F;8;0;1;2398;212508;12645
Sjælland;2021-03-02;F;51;0;5;2398;212559;12650
Syddanmark;2021-03-02;F;71;0;4;2398;212630;12654
Hovedstaden;2021-03-02;M;133;1;12;2399;212763;12666
Midtjylland;2021-03-02;M;43;0;1;2399;212806;12667
Nordjylland;2021-03-02;M;11;0;0;2399;212817;12667
Sjælland;2021-03-02;M;46;0;4;2399;212863;12671
Syddanmark;2021-03-02;M;76;0;4;2399;212939;12675
Hovedstaden;2021-03-03;F;108;0;4;2399;213047;12679
Midtjylland;2021-03-03;F;40;0;3;2399;213087;12682
Nordjylland;2021-03-03;F;10;0;0;2399;213097;12682
Sjælland;2021-03-03;F;41;0;3;2399;213138;12685
Syddanmark;2021-03-03;F;77;0;7;2399;213215;12692
Hovedstaden;2021-03-03;M;112;0;4;2399;213327;12696
Midtjylland;2021-03-03;M;35;0;0;2399;213362;12696
Nordjylland;2021-03-03;M;12;0;0;2399;213374;12696
Sjælland;2021-03-03;M;43;0;4;2399;213417;12700
Syddanmark;2021-03-03;M;70;1;5;2400;213487;12705
Hovedstaden;2021-03-04;F;123;0;5;2400;213610;12710
Midtjylland;2021-03-04;F;24;0;0;2400;213634;12710
Nordjylland;2021-03-04;F;10;0;0;2400;213644;12710
Sjælland;2021-03-04;F;42;0;0;2400;213686;12710
Syddanmark;2021-03-04;F;43;1;3;2401;213729;12713
Hovedstaden;2021-03-04;M;105;0;3;2401;213834;12716
Midtjylland;2021-03-04;M;25;0;1;2401;213859;12717
Nordjylland;2021-03-04;M;8;0;0;2401;213867;12717
Sjælland;2021-03-04;M;40;0;3;2401;213907;12720
Syddanmark;2021-03-04;M;69;0;3;2401;213976;12723
Hovedstaden;2021-03-05;F;101;0;9;2401;214077;12732
Midtjylland;2021-03-05;F;38;0;3;2401;214115;12735
Nordjylland;2021-03-05;F;7;0;0;2401;214122;12735
Sjælland;2021-03-05;F;30;0;0;2401;214152;12735
Syddanmark;2021-03-05;F;40;0;2;2401;214192;12737
Hovedstaden;2021-03-05;M;113;3;9;2404;214305;12746
Midtjylland;2021-03-05;M;20;0;1;2404;214325;12747
Nordjylland;2021-03-05;M;14;0;1;2404;214339;12748
Sjælland;2021-03-05;M;36;1;5;2405;214375;12753
Syddanmark;2021-03-05;M;74;0;3;2405;214449;12756
Hovedstaden;2021-03-06;F;110;0;4;2405;214559;12760
Midtjylland;2021-03-06;F;29;0;1;2405;214588;12761
Nordjylland;2021-03-06;F;9;0;0;2405;214597;12761
Sjælland;2021-03-06;F;30;0;2;2405;214627;12763
Syddanmark;2021-03-06;F;46;0;0;2405;214673;12763
Hovedstaden;2021-03-06;M;97;0;6;2405;214770;12769
Midtjylland;2021-03-06;M;18;0;1;2405;214788;12770
Nordjylland;2021-03-06;M;10;0;1;2405;214798;12771
Sjælland;2021-03-06;M;42;0;6;2405;214840;12777
Syddanmark;2021-03-06;M;66;1;7;2406;214906;12784
Hovedstaden;2021-03-07;F;106;1;9;2407;215012;12793
Midtjylland;2021-03-07;F;46;0;1;2407;215058;12794
Nordjylland;2021-03-07;F;14;0;1;2407;215072;12795
Sjælland;2021-03-07;F;27;0;3;2407;215099;12798
Syddanmark;2021-03-07;F;48;0;2;2407;215147;12800
Hovedstaden;2021-03-07;M;87;0;5;2407;215234;12805
Midtjylland;2021-03-07;M;27;0;2;2407;215261;12807
Nordjylland;2021-03-07;M;10;0;0;2407;215271;12807
Sjælland;2021-03-07;M;34;0;3;2407;215305;12810
Syddanmark;2021-03-07;M;60;0;1;2407;215365;12811
Hovedstaden;2021-03-08;F;111;0;8;2407;215476;12819
Midtjylland;2021-03-08;F;42;0;4;2407;215518;12823
Nordjylland;2021-03-08;F;14;0;0;2407;215532;12823
Sjælland;2021-03-08;F;47;1;3;2408;215579;12826
Syddanmark;2021-03-08;F;66;0;3;2408;215645;12829
Hovedstaden;2021-03-08;M;146;0;9;2408;215791;12838
Midtjylland;2021-03-08;M;52;0;2;2408;215843;12840
Nordjylland;2021-03-08;M;7;0;1;2408;215850;12841
Sjælland;2021-03-08;M;33;0;2;2408;215883;12843
Syddanmark;2021-03-08;M;84;0;2;2408;215967;12845
Hovedstaden;2021-03-09;F;118;0;6;2408;216085;12851
Midtjylland;2021-03-09;F;36;0;2;2408;216121;12853
Nordjylland;2021-03-09;F;5;0;0;2408;216126;12853
Sjælland;2021-03-09;F;42;0;3;2408;216168;12856
Syddanmark;2021-03-09;F;92;0;5;2408;216260;12861
Hovedstaden;2021-03-09;M;150;0;11;2408;216410;12872
Midtjylland;2021-03-09;M;53;0;1;2408;216463;12873
Nordjylland;2021-03-09;M;13;0;2;2408;216476;12875
Sjælland;2021-03-09;M;39;2;6;2410;216515;12881
Syddanmark;2021-03-09;M;94;0;3;2410;216609;12884
Hovedstaden;2021-03-10;F;112;1;6;2411;216721;12890
Midtjylland;2021-03-10;F;40;0;1;2411;216761;12891
Nordjylland;2021-03-10;F;8;0;0;2411;216769;12891
Sjælland;2021-03-10;F;29;0;2;2411;216798;12893
Syddanmark;2021-03-10;F;84;0;5;2411;216882;12898
Hovedstaden;2021-03-10;M;102;0;4;2411;216984;12902
Midtjylland;2021-03-10;M;41;0;3;2411;217025;12905
Nordjylland;2021-03-10;M;16;0;0;2411;217041;12905
Sjælland;2021-03-10;M;32;0;1;2411;217073;12906
Syddanmark;2021-03-10;M;82;0;4;2411;217155;12910
Hovedstaden;2021-03-11;F;137;0;7;2411;217292;12917
Midtjylland;2021-03-11;F;35;0;3;2411;217327;12920
Nordjylland;2021-03-11;F;16;1;2;2412;217343;12922
Sjælland;2021-03-11;F;37;1;2;2413;217380;12924
Syddanmark;2021-03-11;F;75;0;4;2413;217455;12928
Hovedstaden;2021-03-11;M;115;0;5;2413;217570;12933
Midtjylland;2021-03-11;M;36;0;2;2413;217606;12935
Nordjylland;2021-03-11;M;18;0;0;2413;217624;12935
Sjælland;2021-03-11;M;47;1;3;2414;217671;12938
Syddanmark;2021-03-11;M;72;0;3;2414;217743;12941
Hovedstaden;2021-03-12;F;114;0;2;2414;217857;12943
Midtjylland;2021-03-12;F;35;0;3;2414;217892;12946
Nordjylland;2021-03-12;F;13;0;0;2414;217905;12946
Sjælland;2021-03-12;F;32;1;3;2415;217937;12949
Syddanmark;2021-03-12;F;65;0;5;2415;218002;12954
Hovedstaden;2021-03-12;M;108;1;6;2416;218110;12960
Midtjylland;2021-03-12;M;27;0;2;2416;218137;12962
Nordjylland;2021-03-12;M;7;0;0;2416;218144;12962
Sjælland;2021-03-12;M;31;0;3;2416;218175;12965
Syddanmark;2021-03-12;M;59;0;3;2416;218234;12968
Hovedstaden;2021-03-13;F;86;0;5;2416;218320;12973
Midtjylland;2021-03-13;F;35;0;0;2416;218355;12973
Nordjylland;2021-03-13;F;11;0;0;2416;218366;12973
Sjælland;2021-03-13;F;24;0;2;2416;218390;12975
Syddanmark;2021-03-13;F;69;0;4;2416;218459;12979
Hovedstaden;2021-03-13;M;107;0;10;2416;218566;12989
Midtjylland;2021-03-13;M;25;0;1;2416;218591;12990
Nordjylland;2021-03-13;M;13;0;1;2416;218604;12991
Sjælland;2021-03-13;M;23;0;1;2416;218627;12992
Syddanmark;2021-03-13;M;71;0;3;2416;218698;12995
Hovedstaden;2021-03-14;F;95;0;6;2416;218793;13001
Midtjylland;2021-03-14;F;33;0;0;2416;218826;13001
Nordjylland;2021-03-14;F;13;0;0;2416;218839;13001
Sjælland;2021-03-14;F;25;0;1;2416;218864;13002
Syddanmark;2021-03-14;F;65;1;5;2417;218929;13007
Hovedstaden;2021-03-14;M;122;1;6;2418;219051;13013
Midtjylland;2021-03-14;M;36;0;0;2418;219087;13013
Nordjylland;2021-03-14;M;10;0;0;2418;219097;13013
Sjælland;2021-03-14;M;22;0;0;2418;219119;13013
Syddanmark;2021-03-14;M;67;1;2;2419;219186;13015
Hovedstaden;2021-03-15;F;123;0;6;2419;219309;13021
Midtjylland;2021-03-15;F;45;0;5;2419;219354;13026
Nordjylland;2021-03-15;F;13;0;0;2419;219367;13026
Sjælland;2021-03-15;F;45;1;3;2420;219412;13029
Syddanmark;2021-03-15;F;103;0;3;2420;219515;13032
Hovedstaden;2021-03-15;M;135;2;12;2422;219650;13044
Midtjylland;2021-03-15;M;39;0;3;2422;219689;13047
Nordjylland;2021-03-15;M;15;0;0;2422;219704;13047
Sjælland;2021-03-15;M;38;1;3;2423;219742;13050
Syddanmark;2021-03-15;M;88;1;6;2424;219830;13056
Hovedstaden;2021-03-16;F;128;1;10;2425;219958;13066
Midtjylland;2021-03-16;F;46;0;3;2425;220004;13069
Nordjylland;2021-03-16;F;22;0;0;2425;220026;13069
Sjælland;2021-03-16;F;42;0;3;2425;220068;13072
Syddanmark;2021-03-16;F;102;0;2;2425;220170;13074
Hovedstaden;2021-03-16;M;155;1;9;2426;220325;13083
Midtjylland;2021-03-16;M;79;0;3;2426;220404;13086
Nordjylland;2021-03-16;M;27;0;3;2426;220431;13089
Sjælland;2021-03-16;M;52;0;3;2426;220483;13092
Syddanmark;2021-03-16;M;99;0;7;2426;220582;13099
Hovedstaden;2021-03-17;F;125;0;5;2426;220707;13104
Midtjylland;2021-03-17;F;43;0;1;2426;220750;13105
Nordjylland;2021-03-17;F;18;0;1;2426;220768;13106
Sjælland;2021-03-17;F;46;0;1;2426;220814;13107
Syddanmark;2021-03-17;F;81;0;4;2426;220895;13111
Hovedstaden;2021-03-17;M;131;0;8;2426;221026;13119
Midtjylland;2021-03-17;M;45;0;0;2426;221071;13119
Nordjylland;2021-03-17;M;24;0;1;2426;221095;13120
Sjælland;2021-03-17;M;44;1;2;2427;221139;13122
Syddanmark;2021-03-17;M;115;2;3;2429;221254;13125
Hovedstaden;2021-03-18;F;149;3;4;2432;221403;13129
Midtjylland;2021-03-18;F;40;0;2;2432;221443;13131
Nordjylland;2021-03-18;F;11;0;0;2432;221454;13131
Sjælland;2021-03-18;F;39;0;2;2432;221493;13133
Syddanmark;2021-03-18;F;91;0;3;2432;221584;13136
Hovedstaden;2021-03-18;M;142;1;9;2433;221726;13145
Midtjylland;2021-03-18;M;35;0;3;2433;221761;13148
Nordjylland;2021-03-18;M;19;0;2;2433;221780;13150
Sjælland;2021-03-18;M;45;0;3;2433;221825;13153
Syddanmark;2021-03-18;M;83;1;5;2434;221908;13158
Hovedstaden;2021-03-19;F;166;0;6;2434;222074;13164
Midtjylland;2021-03-19;F;42;0;1;2434;222116;13165
Nordjylland;2021-03-19;F;10;0;1;2434;222126;13166
Sjælland;2021-03-19;F;42;1;4;2435;222168;13170
Syddanmark;2021-03-19;F;64;0;4;2435;222232;13174
Hovedstaden;2021-03-19;M;165;0;4;2435;222397;13178
Midtjylland;2021-03-19;M;33;0;0;2435;222430;13178
Nordjylland;2021-03-19;M;11;0;1;2435;222441;13179
Sjælland;2021-03-19;M;41;0;5;2435;222482;13184
Syddanmark;2021-03-19;M;73;0;3;2435;222555;13187
Hovedstaden;2021-03-20;F;123;0;4;2435;222678;13191
Midtjylland;2021-03-20;F;26;1;1;2436;222704;13192
Nordjylland;2021-03-20;F;19;0;5;2436;222723;13197
Sjælland;2021-03-20;F;27;1;2;2437;222750;13199
Syddanmark;2021-03-20;F;71;0;2;2437;222821;13201
Hovedstaden;2021-03-20;M;168;0;12;2437;222989;13213
Midtjylland;2021-03-20;M;42;0;1;2437;223031;13214
Nordjylland;2021-03-20;M;21;0;0;2437;223052;13214
Sjælland;2021-03-20;M;29;0;2;2437;223081;13216
Syddanmark;2021-03-20;M;61;0;2;2437;223142;13218
Hovedstaden;2021-03-21;F;134;0;6;2437;223276;13224
Midtjylland;2021-03-21;F;39;0;2;2437;223315;13226
Nordjylland;2021-03-21;F;16;0;1;2437;223331;13227
Sjælland;2021-03-21;F;23;0;1;2437;223354;13228
Syddanmark;2021-03-21;F;62;0;3;2437;223416;13231
Hovedstaden;2021-03-21;M;145;1;7;2438;223561;13238
Midtjylland;2021-03-21;M;46;0;3;2438;223607;13241
Nordjylland;2021-03-21;M;15;0;0;2438;223622;13241
Sjælland;2021-03-21;M;28;1;1;2439;223650;13242
Syddanmark;2021-03-21;M;59;0;4;2439;223709;13246
Hovedstaden;2021-03-22;F;177;1;10;2440;223886;13256
Midtjylland;2021-03-22;F;44;1;3;2441;223930;13259
Nordjylland;2021-03-22;F;22;0;1;2441;223952;13260
Sjælland;2021-03-22;F;42;1;4;2442;223994;13264
Syddanmark;2021-03-22;F;85;0;2;2442;224079;13266
Hovedstaden;2021-03-22;M;193;2;13;2444;224272;13279
Midtjylland;2021-03-22;M;57;0;2;2444;224329;13281
Nordjylland;2021-03-22;M;25;0;1;2444;224354;13282
Sjælland;2021-03-22;M;41;0;2;2444;224395;13284
Syddanmark;2021-03-22;M;104;0;4;2444;224499;13288
Hovedstaden;2021-03-23;F;179;0;14;2444;224678;13302
Midtjylland;2021-03-23;F;76;0;2;2444;224754;13304
Nordjylland;2021-03-23;F;11;0;1;2444;224765;13305
Sjælland;2021-03-23;F;42;0;3;2444;224807;13308
Syddanmark;2021-03-23;F;76;1;3;2445;224883;13311
Hovedstaden;2021-03-23;M;214;2;6;2447;225097;13317
Midtjylland;2021-03-23;M;51;0;4;2447;225148;13321
Nordjylland;2021-03-23;M;24;0;2;2447;225172;13323
Sjælland;2021-03-23;M;47;0;1;2447;225219;13324
Syddanmark;2021-03-23;M;84;0;3;2447;225303;13327
Hovedstaden;2021-03-24;F;207;1;6;2448;225510;13333
Midtjylland;2021-03-24;F;50;0;1;2448;225560;13334
Nordjylland;2021-03-24;F;18;0;1;2448;225578;13335
Sjælland;2021-03-24;F;40;0;3;2448;225618;13338
Syddanmark;2021-03-24;F;80;0;0;2448;225698;13338
Hovedstaden;2021-03-24;M;187;0;9;2448;225885;13347
Midtjylland;2021-03-24;M;62;2;7;2450;225947;13354
Nordjylland;2021-03-24;M;24;0;1;2450;225971;13355
Sjælland;2021-03-24;M;43;0;3;2450;226014;13358
Syddanmark;2021-03-24;M;82;0;5;2450;226096;13363
Hovedstaden;2021-03-25;F;177;1;11;2451;226273;13374
Midtjylland;2021-03-25;F;40;1;4;2452;226313;13378
Nordjylland;2021-03-25;F;8;0;1;2452;226321;13379
Sjælland;2021-03-25;F;32;0;3;2452;226353;13382
Syddanmark;2021-03-25;F;59;0;2;2452;226412;13384
Hovedstaden;2021-03-25;M;180;0;13;2452;226592;13397
Midtjylland;2021-03-25;M;40;0;0;2452;226632;13397
Nordjylland;2021-03-25;M;21;0;2;2452;226653;13399
Sjælland;2021-03-25;M;35;0;1;2452;226688;13400
Syddanmark;2021-03-25;M;59;0;3;2452;226747;13403
Hovedstaden;2021-03-26;F;177;0;10;2452;226924;13413
Midtjylland;2021-03-26;F;41;0;1;2452;226965;13414
Nordjylland;2021-03-26;F;11;0;0;2452;226976;13414
Sjælland;2021-03-26;F;36;0;0;2452;227012;13414
Syddanmark;2021-03-26;F;69;0;5;2452;227081;13419
Hovedstaden;2021-03-26;M;202;0;9;2452;227283;13428
Midtjylland;2021-03-26;M;39;0;0;2452;227322;13428
Nordjylland;2021-03-26;M;14;0;1;2452;227336;13429
Sjælland;2021-03-26;M;43;0;3;2452;227379;13432
Syddanmark;2021-03-26;M;70;0;3;2452;227449;13435
Hovedstaden;2021-03-27;F;176;0;8;2452;227625;13443
Midtjylland;2021-03-27;F;54;0;3;2452;227679;13446
Nordjylland;2021-03-27;F;16;0;0;2452;227695;13446
Sjælland;2021-03-27;F;33;0;3;2452;227728;13449
Syddanmark;2021-03-27;F;74;0;5;2452;227802;13454
Hovedstaden;2021-03-27;M;162;2;15;2454;227964;13469
Midtjylland;2021-03-27;M;47;1;4;2455;228011;13473
Nordjylland;2021-03-27;M;20;0;3;2455;228031;13476
Sjælland;2021-03-27;M;46;0;11;2455;228077;13487
Syddanmark;2021-03-27;M;46;0;1;2455;228123;13488
Hovedstaden;2021-03-28;F;158;1;6;2456;228281;13494
Midtjylland;2021-03-28;F;40;1;5;2457;228321;13499
Nordjylland;2021-03-28;F;11;0;2;2457;228332;13501
Sjælland;2021-03-28;F;26;0;1;2457;228358;13502
Syddanmark;2021-03-28;F;64;1;1;2458;228422;13503
Hovedstaden;2021-03-28;M;164;0;4;2458;228586;13507
Midtjylland;2021-03-28;M;37;0;3;2458;228623;13510
Nordjylland;2021-03-28;M;14;0;0;2458;228637;13510
Sjælland;2021-03-28;M;39;0;4;2458;228676;13514
Syddanmark;2021-03-28;M;61;0;2;2458;228737;13516
Hovedstaden;2021-03-29;F;198;2;15;2460;228935;13531
Midtjylland;2021-03-29;F;55;0;1;2460;228990;13532
Nordjylland;2021-03-29;F;14;0;1;2460;229004;13533
Sjælland;2021-03-29;F;47;1;1;2461;229051;13534
Syddanmark;2021-03-29;F;74;0;6;2461;229125;13540
Hovedstaden;2021-03-29;M;208;3;21;2464;229333;13561
Midtjylland;2021-03-29;M;42;0;3;2464;229375;13564
Nordjylland;2021-03-29;M;26;0;0;2464;229401;13564
Sjælland;2021-03-29;M;42;0;3;2464;229443;13567
Syddanmark;2021-03-29;M;59;0;3;2464;229502;13570
Hovedstaden;2021-03-30;F;195;2;14;2466;229697;13584
Midtjylland;2021-03-30;F;48;1;5;2467;229745;13589
Nordjylland;2021-03-30;F;20;0;3;2467;229765;13592
Sjælland;2021-03-30;F;31;0;2;2467;229796;13594
Syddanmark;2021-03-30;F;62;0;3;2467;229858;13597
Hovedstaden;2021-03-30;M;175;1;13;2468;230033;13610
Midtjylland;2021-03-30;M;45;0;3;2468;230078;13613
Nordjylland;2021-03-30;M;22;0;1;2468;230100;13614
Sjælland;2021-03-30;M;32;0;1;2468;230132;13615
Syddanmark;2021-03-30;M;47;0;0;2468;230179;13615
Hovedstaden;2021-03-31;F;176;0;8;2468;230355;13623
Midtjylland;2021-03-31;F;46;1;0;2469;230401;13623
Nordjylland;2021-03-31;F;21;0;0;2469;230422;13623
Sjælland;2021-03-31;F;24;2;6;2471;230446;13629
Syddanmark;2021-03-31;F;51;0;2;2471;230497;13631
Hovedstaden;2021-03-31;M;200;1;13;2472;230697;13644
Midtjylland;2021-03-31;M;53;0;6;2472;230750;13650
Nordjylland;2021-03-31;M;29;0;0;2472;230779;13650
Sjælland;2021-03-31;M;35;0;2;2472;230814;13652
Syddanmark;2021-03-31;M;57;1;3;2473;230871;13655
Hovedstaden;2021-04-01;F;182;1;8;2474;231053;13663
Midtjylland;2021-04-01;F;58;0;4;2474;231111;13667
Nordjylland;2021-04-01;F;22;0;1;2474;231133;13668
Sjælland;2021-04-01;F;46;0;1;2474;231179;13669
Syddanmark;2021-04-01;F;65;0;1;2474;231244;13670
Hovedstaden;2021-04-01;M;178;0;13;2474;231422;13683
Midtjylland;2021-04-01;M;53;0;8;2474;231475;13691
Nordjylland;2021-04-01;M;24;0;0;2474;231499;13691
Sjælland;2021-04-01;M;44;0;0;2474;231543;13691
Syddanmark;2021-04-01;M;41;0;5;2474;231584;13696
Hovedstaden;2021-04-02;F;150;0;6;2474;231734;13702
Midtjylland;2021-04-02;F;46;0;2;2474;231780;13704
Nordjylland;2021-04-02;F;18;0;0;2474;231798;13704
Sjælland;2021-04-02;F;30;0;1;2474;231828;13705
Syddanmark;2021-04-02;F;40;0;1;2474;231868;13706
Hovedstaden;2021-04-02;M;127;0;9;2474;231995;13715
Midtjylland;2021-04-02;M;45;0;1;2474;232040;13716
Nordjylland;2021-04-02;M;18;0;2;2474;232058;13718
Sjælland;2021-04-02;M;34;0;4;2474;232092;13722
Syddanmark;2021-04-02;M;46;0;2;2474;232138;13724
Hovedstaden;2021-04-03;F;116;0;3;2474;232254;13727
Midtjylland;2021-04-03;F;59;0;3;2474;232313;13730
Nordjylland;2021-04-03;F;13;0;0;2474;232326;13730
Sjælland;2021-04-03;F;26;0;2;2474;232352;13732
Syddanmark;2021-04-03;F;43;0;1;2474;232395;13733
Hovedstaden;2021-04-03;M;126;1;9;2475;232521;13742
Midtjylland;2021-04-03;M;50;1;2;2476;232571;13744
Nordjylland;2021-04-03;M;26;0;1;2476;232597;13745
Sjælland;2021-04-03;M;30;0;0;2476;232627;13745
Syddanmark;2021-04-03;M;30;0;1;2476;232657;13746
Hovedstaden;2021-04-04;F;127;0;7;2476;232784;13753
Midtjylland;2021-04-04;F;36;0;0;2476;232820;13753
Nordjylland;2021-04-04;F;17;0;1;2476;232837;13754
Sjælland;2021-04-04;F;16;0;2;2476;232853;13756
Syddanmark;2021-04-04;F;36;0;4;2476;232889;13760
Hovedstaden;2021-04-04;M;116;0;3;2476;233005;13763
Midtjylland;2021-04-04;M;41;0;1;2476;233046;13764
Nordjylland;2021-04-04;M;26;0;1;2476;233072;13765
Sjælland;2021-04-04;M;25;0;0;2476;233097;13765
Syddanmark;2021-04-04;M;27;0;1;2476;233124;13766
Hovedstaden;2021-04-05;F;131;0;3;2476;233255;13769
Midtjylland;2021-04-05;F;50;0;1;2476;233305;13770
Nordjylland;2021-04-05;F;28;0;3;2476;233333;13773
Sjælland;2021-04-05;F;31;0;1;2476;233364;13774
Syddanmark;2021-04-05;F;39;0;1;2476;233403;13775
Hovedstaden;2021-04-05;M;140;0;6;2476;233543;13781
Midtjylland;2021-04-05;M;38;0;2;2476;233581;13783
Nordjylland;2021-04-05;M;25;0;1;2476;233606;13784
Sjælland;2021-04-05;M;35;0;3;2476;233641;13787
Syddanmark;2021-04-05;M;41;0;4;2476;233682;13791
Hovedstaden;2021-04-06;F;178;0;10;2476;233860;13801
Midtjylland;2021-04-06;F;40;0;2;2476;233900;13803
Nordjylland;2021-04-06;F;21;0;1;2476;233921;13804
Sjælland;2021-04-06;F;34;0;3;2476;233955;13807
Syddanmark;2021-04-06;F;54;0;5;2476;234009;13812
Hovedstaden;2021-04-06;M;203;0;11;2476;234212;13823
Midtjylland;2021-04-06;M;59;0;5;2476;234271;13828
Nordjylland;2021-04-06;M;32;0;0;2476;234303;13828
Sjælland;2021-04-06;M;30;0;1;2476;234333;13829
Syddanmark;2021-04-06;M;55;0;2;2476;234388;13831
Hovedstaden;2021-04-07;F;148;1;6;2477;234536;13837
Midtjylland;2021-04-07;F;54;0;3;2477;234590;13840
Nordjylland;2021-04-07;F;38;0;2;2477;234628;13842
Sjælland;2021-04-07;F;36;0;3;2477;234664;13845
Syddanmark;2021-04-07;F;57;0;2;2477;234721;13847
Hovedstaden;2021-04-07;M;180;2;6;2479;234901;13853
Midtjylland;2021-04-07;M;54;0;2;2479;234955;13855
Nordjylland;2021-04-07;M;30;0;1;2479;234985;13856
Sjælland;2021-04-07;M;50;0;5;2479;235035;13861
Syddanmark;2021-04-07;M;62;0;4;2479;235097;13865
Hovedstaden;2021-04-08;F;182;1;7;2480;235279;13872
Midtjylland;2021-04-08;F;68;1;3;2481;235347;13875
Nordjylland;2021-04-08;F;11;0;0;2481;235358;13875
Sjælland;2021-04-08;F;47;0;2;2481;235405;13877
Syddanmark;2021-04-08;F;39;1;1;2482;235444;13878
Hovedstaden;2021-04-08;M;176;0;8;2482;235620;13886
Midtjylland;2021-04-08;M;60;1;3;2483;235680;13889
Nordjylland;2021-04-08;M;28;1;3;2484;235708;13892
Sjælland;2021-04-08;M;51;0;4;2484;235759;13896
Syddanmark;2021-04-08;M;51;0;6;2484;235810;13902
Hovedstaden;2021-04-09;F;179;2;10;2486;235989;13912
Midtjylland;2021-04-09;F;44;0;3;2486;236033;13915
Nordjylland;2021-04-09;F;26;2;3;2488;236059;13918
Sjælland;2021-04-09;F;45;0;2;2488;236104;13920
Syddanmark;2021-04-09;F;48;0;0;2488;236152;13920
Hovedstaden;2021-04-09;M;195;1;7;2489;236347;13927
Midtjylland;2021-04-09;M;50;0;3;2489;236397;13930
Nordjylland;2021-04-09;M;28;0;1;2489;236425;13931
Sjælland;2021-04-09;M;48;0;2;2489;236473;13933
Syddanmark;2021-04-09;M;62;0;2;2489;236535;13935
Hovedstaden;2021-04-10;F;129;0;5;2489;236664;13940
Midtjylland;2021-04-10;F;35;0;6;2489;236699;13946
Nordjylland;2021-04-10;F;26;0;1;2489;236725;13947
Sjælland;2021-04-10;F;26;0;0;2489;236751;13947
Syddanmark;2021-04-10;F;47;0;1;2489;236798;13948
Hovedstaden;2021-04-10;M;134;1;3;2490;236932;13951
Midtjylland;2021-04-10;M;41;0;1;2490;236973;13952
Nordjylland;2021-04-10;M;32;0;0;2490;237005;13952
Sjælland;2021-04-10;M;31;0;2;2490;237036;13954
Syddanmark;2021-04-10;M;46;1;4;2491;237082;13958
Hovedstaden;2021-04-11;F;123;0;3;2491;237205;13961
Midtjylland;2021-04-11;F;56;1;3;2492;237261;13964
Nordjylland;2021-04-11;F;18;0;0;2492;237279;13964
Sjælland;2021-04-11;F;31;0;2;2492;237310;13966
Syddanmark;2021-04-11;F;30;0;5;2492;237340;13971
Hovedstaden;2021-04-11;M;116;0;4;2492;237456;13975
Midtjylland;2021-04-11;M;42;0;0;2492;237498;13975
Nordjylland;2021-04-11;M;23;0;0;2492;237521;13975
Sjælland;2021-04-11;M;44;0;2;2492;237565;13977
Syddanmark;2021-04-11;M;49;1;3;2493;237614;13980
Hovedstaden;2021-04-12;F;167;0;16;2493;237781;13996
Midtjylland;2021-04-12;F;46;0;3;2493;237827;13999
Nordjylland;2021-04-12;F;37;2;3;2495;237864;14002
Sjælland;2021-04-12;F;50;0;2;2495;237914;14004
Syddanmark;2021-04-12;F;56;0;5;2495;237970;14009
Hovedstaden;2021-04-12;M;202;3;14;2498;238172;14023
Midtjylland;2021-04-12;M;63;0;2;2498;238235;14025
Nordjylland;2021-04-12;M;31;0;1;2498;238266;14026
Sjælland;2021-04-12;M;57;0;4;2498;238323;14030
Syddanmark;2021-04-12;M;51;0;0;2498;238374;14030
Hovedstaden;2021-04-13;F;153;2;8;2500;238527;14038
Midtjylland;2021-04-13;F;67;0;2;2500;238594;14040
Nordjylland;2021-04-13;F;21;0;1;2500;238615;14041
Sjælland;2021-04-13;F;59;0;0;2500;238674;14041
Syddanmark;2021-04-13;F;43;0;2;2500;238717;14043
Hovedstaden;2021-04-13;M;182;0;10;2500;238899;14053
Midtjylland;2021-04-13;M;85;0;2;2500;238984;14055
Nordjylland;2021-04-13;M;33;0;1;2500;239017;14056
Sjælland;2021-04-13;M;42;0;2;2500;239059;14058
Syddanmark;2021-04-13;M;54;0;1;2500;239113;14059
Hovedstaden;2021-04-14;F;168;0;6;2500;239281;14065
Midtjylland;2021-04-14;F;53;0;2;2500;239334;14067
Nordjylland;2021-04-14;F;24;0;0;2500;239358;14067
Sjælland;2021-04-14;F;35;0;1;2500;239393;14068
Syddanmark;2021-04-14;F;37;0;1;2500;239430;14069
Hovedstaden;2021-04-14;M;167;0;9;2500;239597;14078
Midtjylland;2021-04-14;M;82;1;4;2501;239679;14082
Nordjylland;2021-04-14;M;30;0;0;2501;239709;14082
Sjælland;2021-04-14;M;41;0;5;2501;239750;14087
Syddanmark;2021-04-14;M;57;0;3;2501;239807;14090
Hovedstaden;2021-04-15;F;180;1;6;2502;239987;14096
Midtjylland;2021-04-15;F;85;0;3;2502;240072;14099
Nordjylland;2021-04-15;F;25;0;1;2502;240097;14100
Sjælland;2021-04-15;F;47;0;3;2502;240144;14103
Syddanmark;2021-04-15;F;53;0;4;2502;240197;14107
Hovedstaden;2021-04-15;M;147;2;7;2504;240344;14114
Midtjylland;2021-04-15;M;72;0;7;2504;240416;14121
Nordjylland;2021-04-15;M;24;0;0;2504;240440;14121
Sjælland;2021-04-15;M;43;0;3;2504;240483;14124
Syddanmark;2021-04-15;M;56;0;1;2504;240539;14125
Hovedstaden;2021-04-16;F;163;0;11;2504;240702;14136
Midtjylland;2021-04-16;F;58;0;3;2504;240760;14139
Nordjylland;2021-04-16;F;18;0;0;2504;240778;14139
Sjælland;2021-04-16;F;43;0;1;2504;240821;14140
Syddanmark;2021-04-16;F;42;0;1;2504;240863;14141
Hovedstaden;2021-04-16;M;172;0;4;2504;241035;14145
Midtjylland;2021-04-16;M;86;0;0;2504;241121;14145
Nordjylland;2021-04-16;M;25;0;1;2504;241146;14146
Sjælland;2021-04-16;M;43;1;4;2505;241189;14150
Syddanmark;2021-04-16;M;54;0;1;2505;241243;14151
Hovedstaden;2021-04-17;F;146;0;4;2505;241389;14155
Midtjylland;2021-04-17;F;72;0;6;2505;241461;14161
Nordjylland;2021-04-17;F;29;0;0;2505;241490;14161
Sjælland;2021-04-17;F;36;0;0;2505;241526;14161
Syddanmark;2021-04-17;F;36;0;2;2505;241562;14163
Hovedstaden;2021-04-17;M;162;0;9;2505;241724;14172
Midtjylland;2021-04-17;M;67;0;2;2505;241791;14174
Nordjylland;2021-04-17;M;27;1;0;2506;241818;14174
Sjælland;2021-04-17;M;34;0;1;2506;241852;14175
Syddanmark;2021-04-17;M;43;0;3;2506;241895;14178
Hovedstaden;2021-04-18;F;178;2;10;2508;242073;14188
Midtjylland;2021-04-18;F;76;0;6;2508;242149;14194
Nordjylland;2021-04-18;F;32;0;1;2508;242181;14195
Sjælland;2021-04-18;F;37;0;4;2508;242218;14199
Syddanmark;2021-04-18;F;37;0;4;2508;242255;14203
Hovedstaden;2021-04-18;M;180;0;10;2508;242435;14213
Midtjylland;2021-04-18;M;75;0;0;2508;242510;14213
Nordjylland;2021-04-18;M;18;0;0;2508;242528;14213
Sjælland;2021-04-18;M;41;0;3;2508;242569;14216
Syddanmark;2021-04-18;M;42;0;2;2508;242611;14218
Hovedstaden;2021-04-19;F;198;0;6;2508;242809;14224
Midtjylland;2021-04-19;F;81;0;2;2508;242890;14226
Nordjylland;2021-04-19;F;42;0;1;2508;242932;14227
Sjælland;2021-04-19;F;44;0;2;2508;242976;14229
Syddanmark;2021-04-19;F;53;0;3;2508;243029;14232
Hovedstaden;2021-04-19;M;181;1;10;2509;243210;14242
Midtjylland;2021-04-19;M;101;0;3;2509;243311;14245
Nordjylland;2021-04-19;M;48;1;2;2510;243359;14247
Sjælland;2021-04-19;M;60;0;6;2510;243419;14253
Syddanmark;2021-04-19;M;54;0;3;2510;243473;14256
Hovedstaden;2021-04-20;F;180;0;5;2510;243653;14261
Midtjylland;2021-04-20;F;88;0;7;2510;243741;14268
Nordjylland;2021-04-20;F;29;0;0;2510;243770;14268
Sjælland;2021-04-20;F;47;0;0;2510;243817;14268
Syddanmark;2021-04-20;F;42;0;0;2510;243859;14268
Hovedstaden;2021-04-20;M;183;0;9;2510;244042;14277
Midtjylland;2021-04-20;M;110;0;5;2510;244152;14282
Nordjylland;2021-04-20;M;55;0;3;2510;244207;14285
Sjælland;2021-04-20;M;52;1;4;2511;244259;14289
Syddanmark;2021-04-20;M;62;0;0;2511;244321;14289
Hovedstaden;2021-04-21;F;158;0;6;2511;244479;14295
Midtjylland;2021-04-21;F;63;0;0;2511;244542;14295
Nordjylland;2021-04-21;F;21;0;1;2511;244563;14296
Sjælland;2021-04-21;F;39;0;1;2511;244602;14297
Syddanmark;2021-04-21;F;34;0;2;2511;244636;14299
Hovedstaden;2021-04-21;M;159;1;9;2512;244795;14308
Midtjylland;2021-04-21;M;81;0;3;2512;244876;14311
Nordjylland;2021-04-21;M;18;0;1;2512;244894;14312
Sjælland;2021-04-21;M;47;0;2;2512;244941;14314
Syddanmark;2021-04-21;M;39;0;0;2512;244980;14314
Hovedstaden;2021-04-22;F;142;1;8;2513;245122;14322
Midtjylland;2021-04-22;F;52;0;0;2513;245174;14322
Nordjylland;2021-04-22;F;25;0;0;2513;245199;14322
Sjælland;2021-04-22;F;34;0;3;2513;245233;14325
Syddanmark;2021-04-22;F;35;0;0;2513;245268;14325
Hovedstaden;2021-04-22;M;150;0;3;2513;245418;14328
Midtjylland;2021-04-22;M;52;0;2;2513;245470;14330
Nordjylland;2021-04-22;M;26;0;1;2513;245496;14331
Sjælland;2021-04-22;M;50;0;3;2513;245546;14334
Syddanmark;2021-04-22;M;54;0;0;2513;245600;14334
Hovedstaden;2021-04-23;F;127;0;4;2513;245727;14338
Midtjylland;2021-04-23;F;54;0;1;2513;245781;14339
Nordjylland;2021-04-23;F;38;0;2;2513;245819;14341
Sjælland;2021-04-23;F;35;0;1;2513;245854;14342
Syddanmark;2021-04-23;F;51;0;2;2513;245905;14344
Hovedstaden;2021-04-23;M;140;2;6;2515;246045;14350
Midtjylland;2021-04-23;M;65;0;2;2515;246110;14352
Nordjylland;2021-04-23;M;43;0;1;2515;246153;14353
Sjælland;2021-04-23;M;29;0;1;2515;246182;14354
Syddanmark;2021-04-23;M;43;0;1;2515;246225;14355
Hovedstaden;2021-04-24;F;118;0;9;2515;246343;14364
Midtjylland;2021-04-24;F;62;0;2;2515;246405;14366
Nordjylland;2021-04-24;F;25;0;0;2515;246430;14366
Sjælland;2021-04-24;F;40;0;3;2515;246470;14369
Syddanmark;2021-04-24;F;27;0;2;2515;246497;14371
Hovedstaden;2021-04-24;M;112;0;6;2515;246609;14377
Midtjylland;2021-04-24;M;69;1;4;2516;246678;14381
Nordjylland;2021-04-24;M;36;0;0;2516;246714;14381
Sjælland;2021-04-24;M;29;0;1;2516;246743;14382
Syddanmark;2021-04-24;M;50;0;1;2516;246793;14383
Hovedstaden;2021-04-25;F;152;0;7;2516;246945;14390
Midtjylland;2021-04-25;F;53;0;1;2516;246998;14391
Nordjylland;2021-04-25;F;34;0;2;2516;247032;14393
Sjælland;2021-04-25;F;39;0;4;2516;247071;14397
Syddanmark;2021-04-25;F;35;0;3;2516;247106;14400
Hovedstaden;2021-04-25;M;122;0;5;2516;247228;14405
Midtjylland;2021-04-25;M;65;0;4;2516;247293;14409
Nordjylland;2021-04-25;M;30;0;0;2516;247323;14409
Sjælland;2021-04-25;M;27;0;1;2516;247350;14410
Syddanmark;2021-04-25;M;40;0;1;2516;247390;14411
Hovedstaden;2021-04-26;F;164;0;5;2516;247554;14416
Midtjylland;2021-04-26;F;61;0;2;2516;247615;14418
Nordjylland;2021-04-26;F;29;0;3;2516;247644;14421
Sjælland;2021-04-26;F;46;1;3;2517;247690;14424
Syddanmark;2021-04-26;F;40;0;3;2517;247730;14427
Hovedstaden;2021-04-26;M;185;0;10;2517;247915;14437
Midtjylland;2021-04-26;M;71;0;5;2517;247986;14442
Nordjylland;2021-04-26;M;46;1;7;2518;248032;14449
Sjælland;2021-04-26;M;56;0;3;2518;248088;14452
Syddanmark;2021-04-26;M;74;1;4;2519;248162;14456
Hovedstaden;2021-04-27;F;219;0;13;2519;248381;14469
Midtjylland;2021-04-27;F;62;0;2;2519;248443;14471
Nordjylland;2021-04-27;F;44;0;4;2519;248487;14475
Sjælland;2021-04-27;F;45;0;0;2519;248532;14475
Syddanmark;2021-04-27;F;61;0;1;2519;248593;14476
Hovedstaden;2021-04-27;M;217;0;2;2519;248810;14478
Midtjylland;2021-04-27;M;85;0;3;2519;248895;14481
Nordjylland;2021-04-27;M;32;0;0;2519;248927;14481
Sjælland;2021-04-27;M;51;0;3;2519;248978;14484
Syddanmark;2021-04-27;M;77;0;2;2519;249055;14486
Hovedstaden;2021-04-28;F;209;0;14;2519;249264;14500
Midtjylland;2021-04-28;F;69;0;2;2519;249333;14502
Nordjylland;2021-04-28;F;31;0;1;2519;249364;14503
Sjælland;2021-04-28;F;50;0;5;2519;249414;14508
Syddanmark;2021-04-28;F;49;0;2;2519;249463;14510
Hovedstaden;2021-04-28;M;188;0;6;2519;249651;14516
Midtjylland;2021-04-28;M;77;0;3;2519;249728;14519
Nordjylland;2021-04-28;M;34;0;1;2519;249762;14520
Sjælland;2021-04-28;M;42;0;1;2519;249804;14521
Syddanmark;2021-04-28;M;59;0;2;2519;249863;14523
Hovedstaden;2021-04-29;F;183;0;7;2519;250046;14530
Midtjylland;2021-04-29;F;66;0;5;2519;250112;14535
Nordjylland;2021-04-29;F;24;0;0;2519;250136;14535
Sjælland;2021-04-29;F;47;0;2;2519;250183;14537
Syddanmark;2021-04-29;F;56;0;4;2519;250239;14541
Hovedstaden;2021-04-29;M;199;0;10;2519;250438;14551
Midtjylland;2021-04-29;M;80;0;4;2519;250518;14555
Nordjylland;2021-04-29;M;35;0;2;2519;250553;14557
Sjælland;2021-04-29;M;53;0;1;2519;250606;14558
Syddanmark;2021-04-29;M;57;0;0;2519;250663;14558
Hovedstaden;2021-04-30;F;179;0;6;2519;250842;14564
Midtjylland;2021-04-30;F;58;0;1;2519;250900;14565
Nordjylland;2021-04-30;F;29;0;0;2519;250929;14565
Sjælland;2021-04-30;F;31;0;1;2519;250960;14566
Syddanmark;2021-04-30;F;55;0;2;2519;251015;14568
Hovedstaden;2021-04-30;M;189;0;7;2519;251204;14575
Midtjylland;2021-04-30;M;72;0;4;2519;251276;14579
Nordjylland;2021-04-30;M;35;1;3;2520;251311;14582
Sjælland;2021-04-30;M;38;0;1;2520;251349;14583
Syddanmark;2021-04-30;M;71;0;3;2520;251420;14586
Hovedstaden;2021-05-01;F;149;0;13;2520;251569;14599
Midtjylland;2021-05-01;F;74;0;2;2520;251643;14601
Nordjylland;2021-05-01;F;32;0;3;2520;251675;14604
Sjælland;2021-05-01;F;26;0;1;2520;251701;14605
Syddanmark;2021-05-01;F;48;0;1;2520;251749;14606
Hovedstaden;2021-05-01;M;153;1;7;2521;251902;14613
Midtjylland;2021-05-01;M;86;0;3;2521;251988;14616
Nordjylland;2021-05-01;M;32;0;2;2521;252020;14618
Sjælland;2021-05-01;M;42;0;2;2521;252062;14620
Syddanmark;2021-05-01;M;47;0;1;2521;252109;14621
Hovedstaden;2021-05-02;F;182;0;7;2521;252291;14628
Midtjylland;2021-05-02;F;65;0;3;2521;252356;14631
Nordjylland;2021-05-02;F;33;0;2;2521;252389;14633
Sjælland;2021-05-02;F;26;0;2;2521;252415;14635
Syddanmark;2021-05-02;F;44;0;1;2521;252459;14636
Hovedstaden;2021-05-02;M;176;0;10;2521;252635;14646
Midtjylland;2021-05-02;M;70;0;3;2521;252705;14649
Nordjylland;2021-05-02;M;26;0;1;2521;252731;14650
Sjælland;2021-05-02;M;30;0;2;2521;252761;14652
Syddanmark;2021-05-02;M;60;0;0;2521;252821;14652
Hovedstaden;2021-05-03;F;217;0;10;2521;253038;14662
Midtjylland;2021-05-03;F;98;1;4;2522;253136;14666
Nordjylland;2021-05-03;F;30;0;1;2522;253166;14667
Sjælland;2021-05-03;F;71;0;2;2522;253237;14669
Syddanmark;2021-05-03;F;58;0;1;2522;253295;14670
Hovedstaden;2021-05-03;M;278;0;8;2522;253573;14678
Midtjylland;2021-05-03;M;92;0;2;2522;253665;14680
Nordjylland;2021-05-03;M;43;0;2;2522;253708;14682
Sjælland;2021-05-03;M;64;0;2;2522;253772;14684
Syddanmark;2021-05-03;M;70;0;1;2522;253842;14685
Hovedstaden;2021-05-04;F;250;0;6;2522;254092;14691
Midtjylland;2021-05-04;F;91;0;4;2522;254183;14695
Nordjylland;2021-05-04;F;25;0;0;2522;254208;14695
Sjælland;2021-05-04;F;61;1;4;2523;254269;14699
Syddanmark;2021-05-04;F;59;0;0;2523;254328;14699
Hovedstaden;2021-05-04;M;217;0;5;2523;254545;14704
Midtjylland;2021-05-04;M;106;0;4;2523;254651;14708
Nordjylland;2021-05-04;M;33;0;1;2523;254684;14709
Sjælland;2021-05-04;M;56;0;7;2523;254740;14716
Syddanmark;2021-05-04;M;75;0;2;2523;254815;14718
Hovedstaden;2021-05-05;F;262;1;12;2524;255077;14730
Midtjylland;2021-05-05;F;92;0;1;2524;255169;14731
Nordjylland;2021-05-05;F;43;0;2;2524;255212;14733
Sjælland;2021-05-05;F;59;0;2;2524;255271;14735
Syddanmark;2021-05-05;F;72;0;2;2524;255343;14737
Hovedstaden;2021-05-05;M;250;1;9;2525;255593;14746
Midtjylland;2021-05-05;M;106;0;2;2525;255699;14748
Nordjylland;2021-05-05;M;43;0;1;2525;255742;14749
Sjælland;2021-05-05;M;64;0;7;2525;255806;14756
Syddanmark;2021-05-05;M;63;0;1;2525;255869;14757
Hovedstaden;2021-05-06;F;217;1;4;2526;256086;14761
Midtjylland;2021-05-06;F;71;0;3;2526;256157;14764
Nordjylland;2021-05-06;F;25;0;1;2526;256182;14765
Sjælland;2021-05-06;F;71;0;6;2526;256253;14771
Syddanmark;2021-05-06;F;40;0;1;2526;256293;14772
Hovedstaden;2021-05-06;M;226;0;5;2526;256519;14777
Midtjylland;2021-05-06;M;83;0;2;2526;256602;14779
Nordjylland;2021-05-06;M;31;0;2;2526;256633;14781
Sjælland;2021-05-06;M;76;0;4;2526;256709;14785
Syddanmark;2021-05-06;M;47;0;1;2526;256756;14786
Hovedstaden;2021-05-07;F;210;0;10;2526;256966;14796
Midtjylland;2021-05-07;F;80;0;2;2526;257046;14798
Nordjylland;2021-05-07;F;22;0;1;2526;257068;14799
Sjælland;2021-05-07;F;55;0;2;2526;257123;14801
Syddanmark;2021-05-07;F;58;0;1;2526;257181;14802
Hovedstaden;2021-05-07;M;210;0;12;2526;257391;14814
Midtjylland;2021-05-07;M;96;0;0;2526;257487;14814
Nordjylland;2021-05-07;M;40;1;4;2527;257527;14818
Sjælland;2021-05-07;M;59;0;1;2527;257586;14819
Syddanmark;2021-05-07;M;71;1;2;2528;257657;14821
Hovedstaden;2021-05-08;F;199;0;9;2528;257856;14830
Midtjylland;2021-05-08;F;91;0;4;2528;257947;14834
Nordjylland;2021-05-08;F;24;0;0;2528;257971;14834
Sjælland;2021-05-08;F;47;0;0;2528;258018;14834
Syddanmark;2021-05-08;F;41;0;0;2528;258059;14834
Hovedstaden;2021-05-08;M;241;0;15;2528;258300;14849
Midtjylland;2021-05-08;M;86;0;1;2528;258386;14850
Nordjylland;2021-05-08;M;40;0;1;2528;258426;14851
Sjælland;2021-05-08;M;37;0;0;2528;258463;14851
Syddanmark;2021-05-08;M;42;0;2;2528;258505;14853
Hovedstaden;2021-05-09;F;191;0;7;2528;258696;14860
Midtjylland;2021-05-09;F;62;0;0;2528;258758;14860
Nordjylland;2021-05-09;F;37;0;1;2528;258795;14861
Sjælland;2021-05-09;F;55;0;1;2528;258850;14862
Syddanmark;2021-05-09;F;38;0;4;2528;258888;14866
Hovedstaden;2021-05-09;M;203;0;5;2528;259091;14871
Midtjylland;2021-05-09;M;90;0;2;2528;259181;14873
Nordjylland;2021-05-09;M;36;0;0;2528;259217;14873
Sjælland;2021-05-09;M;45;0;0;2528;259262;14873
Syddanmark;2021-05-09;M;45;0;1;2528;259307;14874
Hovedstaden;2021-05-10;F;237;1;13;2529;259544;14887
Midtjylland;2021-05-10;F;136;0;2;2529;259680;14889
Nordjylland;2021-05-10;F;29;0;1;2529;259709;14890
Sjælland;2021-05-10;F;82;0;2;2529;259791;14892
Syddanmark;2021-05-10;F;53;0;1;2529;259844;14893
Hovedstaden;2021-05-10;M;232;1;5;2530;260076;14898
Midtjylland;2021-05-10;M;149;0;3;2530;260225;14901
Nordjylland;2021-05-10;M;46;0;1;2530;260271;14902
Sjælland;2021-05-10;M;102;0;6;2530;260373;14908
Syddanmark;2021-05-10;M;63;0;1;2530;260436;14909
Hovedstaden;2021-05-11;F;286;0;7;2530;260722;14916
Midtjylland;2021-05-11;F;125;1;3;2531;260847;14919
Nordjylland;2021-05-11;F;52;0;1;2531;260899;14920
Sjælland;2021-05-11;F;77;0;3;2531;260976;14923
Syddanmark;2021-05-11;F;53;0;0;2531;261029;14923
Hovedstaden;2021-05-11;M;338;0;7;2531;261367;14930
Midtjylland;2021-05-11;M;140;0;3;2531;261507;14933
Nordjylland;2021-05-11;M;64;0;2;2531;261571;14935
Sjælland;2021-05-11;M;89;0;3;2531;261660;14938
Syddanmark;2021-05-11;M;76;0;3;2531;261736;14941
Hovedstaden;2021-05-12;F;236;1;11;2532;261972;14952
Midtjylland;2021-05-12;F;110;0;2;2532;262082;14954
Nordjylland;2021-05-12;F;47;0;1;2532;262129;14955
Sjælland;2021-05-12;F;84;0;3;2532;262213;14958
Syddanmark;2021-05-12;F;44;0;5;2532;262257;14963
Hovedstaden;2021-05-12;M;325;1;9;2533;262582;14972
Midtjylland;2021-05-12;M;96;0;2;2533;262678;14974
Nordjylland;2021-05-12;M;56;0;0;2533;262734;14974
Sjælland;2021-05-12;M;103;0;3;2533;262837;14977
Syddanmark;2021-05-12;M;56;1;4;2534;262893;14981
Hovedstaden;2021-05-13;F;213;1;8;2535;263106;14989
Midtjylland;2021-05-13;F;78;0;4;2535;263184;14993
Nordjylland;2021-05-13;F;36;0;2;2535;263220;14995
Sjælland;2021-05-13;F;55;0;3;2535;263275;14998
Syddanmark;2021-05-13;F;43;0;1;2535;263318;14999
Hovedstaden;2021-05-13;M;228;0;6;2535;263546;15005
Midtjylland;2021-05-13;M;74;0;1;2535;263620;15006
Nordjylland;2021-05-13;M;66;0;1;2535;263686;15007
Sjælland;2021-05-13;M;65;0;2;2535;263751;15009
Syddanmark;2021-05-13;M;47;1;2;2536;263798;15011
Hovedstaden;2021-05-14;F;187;0;5;2536;263985;15016
Midtjylland;2021-05-14;F;84;0;1;2536;264069;15017
Nordjylland;2021-05-14;F;43;0;1;2536;264112;15018
Sjælland;2021-05-14;F;78;0;3;2536;264190;15021
Syddanmark;2021-05-14;F;44;0;3;2536;264234;15024
Hovedstaden;2021-05-14;M;211;1;5;2537;264445;15029
Midtjylland;2021-05-14;M;79;0;3;2537;264524;15032
Nordjylland;2021-05-14;M;34;0;1;2537;264558;15033
Sjælland;2021-05-14;M;57;0;4;2537;264615;15037
Syddanmark;2021-05-14;M;55;0;2;2537;264670;15039
Hovedstaden;2021-05-15;F;218;0;9;2537;264888;15048
Midtjylland;2021-05-15;F;83;0;3;2537;264971;15051
Nordjylland;2021-05-15;F;43;0;1;2537;265014;15052
Sjælland;2021-05-15;F;68;1;3;2538;265082;15055
Syddanmark;2021-05-15;F;54;0;4;2538;265136;15059
Hovedstaden;2021-05-15;M;200;0;5;2538;265336;15064
Midtjylland;2021-05-15;M;108;0;5;2538;265444;15069
Nordjylland;2021-05-15;M;54;0;0;2538;265498;15069
Sjælland;2021-05-15;M;65;0;2;2538;265563;15071
Syddanmark;2021-05-15;M;48;0;2;2538;265611;15073
Hovedstaden;2021-05-16;F;211;0;4;2538;265822;15077
Midtjylland;2021-05-16;F;66;0;2;2538;265888;15079
Nordjylland;2021-05-16;F;50;0;0;2538;265938;15079
Sjælland;2021-05-16;F;47;0;3;2538;265985;15082
Syddanmark;2021-05-16;F;47;0;3;2538;266032;15085
Hovedstaden;2021-05-16;M;233;0;8;2538;266265;15093
Midtjylland;2021-05-16;M;82;0;5;2538;266347;15098
Nordjylland;2021-05-16;M;55;0;0;2538;266402;15098
Sjælland;2021-05-16;M;77;0;2;2538;266479;15100
Syddanmark;2021-05-16;M;52;0;0;2538;266531;15100
Hovedstaden;2021-05-17;F;224;0;7;2538;266755;15107
Midtjylland;2021-05-17;F;96;0;5;2538;266851;15112
Nordjylland;2021-05-17;F;42;0;1;2538;266893;15113
Sjælland;2021-05-17;F;68;0;3;2538;266961;15116
Syddanmark;2021-05-17;F;77;0;4;2538;267038;15120
Hovedstaden;2021-05-17;M;278;0;9;2538;267316;15129
Midtjylland;2021-05-17;M;114;0;4;2538;267430;15133
Nordjylland;2021-05-17;M;68;0;0;2538;267498;15133
Sjælland;2021-05-17;M;90;0;1;2538;267588;15134
Syddanmark;2021-05-17;M;93;0;2;2538;267681;15136
Hovedstaden;2021-05-18;F;275;0;8;2538;267956;15144
Midtjylland;2021-05-18;F;85;0;0;2538;268041;15144
Nordjylland;2021-05-18;F;57;0;1;2538;268098;15145
Sjælland;2021-05-18;F;79;0;1;2538;268177;15146
Syddanmark;2021-05-18;F;70;0;5;2538;268247;15151
Hovedstaden;2021-05-18;M;273;0;6;2538;268520;15157
Midtjylland;2021-05-18;M;97;0;4;2538;268617;15161
Nordjylland;2021-05-18;M;64;0;2;2538;268681;15163
Sjælland;2021-05-18;M;79;0;2;2538;268760;15165
Syddanmark;2021-05-18;M;74;0;0;2538;268834;15165
Hovedstaden;2021-05-19;F;246;0;7;2538;269080;15172
Midtjylland;2021-05-19;F;88;0;3;2538;269168;15175
Nordjylland;2021-05-19;F;61;0;3;2538;269229;15178
Sjælland;2021-05-19;F;89;0;3;2538;269318;15181
Syddanmark;2021-05-19;F;62;0;0;2538;269380;15181
Hovedstaden;2021-05-19;M;256;0;8;2538;269636;15189
Midtjylland;2021-05-19;M;90;0;1;2538;269726;15190
Nordjylland;2021-05-19;M;66;0;0;2538;269792;15190
Sjælland;2021-05-19;M;111;0;4;2538;269903;15194
Syddanmark;2021-05-19;M;69;0;2;2538;269972;15196
Hovedstaden;2021-05-20;F;236;0;6;2538;270208;15202
Midtjylland;2021-05-20;F;64;0;0;2538;270272;15202
Nordjylland;2021-05-20;F;67;0;1;2538;270339;15203
Sjælland;2021-05-20;F;69;0;2;2538;270408;15205
Syddanmark;2021-05-20;F;61;0;0;2538;270469;15205
Hovedstaden;2021-05-20;M;219;0;7;2538;270688;15212
Midtjylland;2021-05-20;M;80;0;1;2538;270768;15213
Nordjylland;2021-05-20;M;77;0;2;2538;270845;15215
Sjælland;2021-05-20;M;87;0;4;2538;270932;15219
Syddanmark;2021-05-20;M;57;0;0;2538;270989;15219
Hovedstaden;2021-05-21;F;183;0;6;2538;271172;15225
Midtjylland;2021-05-21;F;65;0;2;2538;271237;15227
Nordjylland;2021-05-21;F;49;0;1;2538;271286;15228
Sjælland;2021-05-21;F;62;0;3;2538;271348;15231
Syddanmark;2021-05-21;F;49;0;1;2538;271397;15232
Hovedstaden;2021-05-21;M;193;1;9;2539;271590;15241
Midtjylland;2021-05-21;M;68;1;3;2540;271658;15244
Nordjylland;2021-05-21;M;38;0;1;2540;271696;15245
Sjælland;2021-05-21;M;74;0;1;2540;271770;15246
Syddanmark;2021-05-21;M;49;1;2;2541;271819;15248
Hovedstaden;2021-05-22;F;162;0;7;2541;271981;15255
Midtjylland;2021-05-22;F;85;0;2;2541;272066;15257
Nordjylland;2021-05-22;F;51;0;0;2541;272117;15257
Sjælland;2021-05-22;F;47;0;2;2541;272164;15259
Syddanmark;2021-05-22;F;55;0;0;2541;272219;15259
Hovedstaden;2021-05-22;M;166;0;8;2541;272385;15267
Midtjylland;2021-05-22;M;83;0;2;2541;272468;15269
Nordjylland;2021-05-22;M;49;0;0;2541;272517;15269
Sjælland;2021-05-22;M;36;0;3;2541;272553;15272
Syddanmark;2021-05-22;M;51;0;4;2541;272604;15276
Hovedstaden;2021-05-23;F;156;0;6;2541;272760;15282
Midtjylland;2021-05-23;F;85;0;1;2541;272845;15283
Nordjylland;2021-05-23;F;61;0;1;2541;272906;15284
Sjælland;2021-05-23;F;41;0;3;2541;272947;15287
Syddanmark;2021-05-23;F;50;0;1;2541;272997;15288
Hovedstaden;2021-05-23;M;149;0;7;2541;273146;15295
Midtjylland;2021-05-23;M;96;0;2;2541;273242;15297
Nordjylland;2021-05-23;M;53;0;0;2541;273295;15297
Sjælland;2021-05-23;M;57;0;4;2541;273352;15301
Syddanmark;2021-05-23;M;53;0;2;2541;273405;15303
Hovedstaden;2021-05-24;F;181;0;10;2541;273586;15313
Midtjylland;2021-05-24;F;83;0;0;2541;273669;15313
Nordjylland;2021-05-24;F;47;0;2;2541;273716;15315
Sjælland;2021-05-24;F;57;0;2;2541;273773;15317
Syddanmark;2021-05-24;F;50;0;1;2541;273823;15318
Hovedstaden;2021-05-24;M;176;0;4;2541;273999;15322
Midtjylland;2021-05-24;M;98;0;3;2541;274097;15325
Nordjylland;2021-05-24;M;52;1;5;2542;274149;15330
Sjælland;2021-05-24;M;64;0;0;2542;274213;15330
Syddanmark;2021-05-24;M;52;0;1;2542;274265;15331
Hovedstaden;2021-05-25;F;191;0;6;2542;274456;15337
Midtjylland;2021-05-25;F;98;0;3;2542;274554;15340
Nordjylland;2021-05-25;F;71;0;2;2542;274625;15342
Sjælland;2021-05-25;F;57;0;2;2542;274682;15344
Syddanmark;2021-05-25;F;70;0;2;2542;274752;15346
Hovedstaden;2021-05-25;M;234;0;9;2542;274986;15355
Midtjylland;2021-05-25;M;124;0;2;2542;275110;15357
Nordjylland;2021-05-25;M;81;0;2;2542;275191;15359
Sjælland;2021-05-25;M;73;0;3;2542;275264;15362
Syddanmark;2021-05-25;M;101;0;1;2542;275365;15363
Hovedstaden;2021-05-26;F;254;0;5;2542;275619;15368
Midtjylland;2021-05-26;F;82;0;2;2542;275701;15370
Nordjylland;2021-05-26;F;68;0;1;2542;275769;15371
Sjælland;2021-05-26;F;51;0;1;2542;275820;15372
Syddanmark;2021-05-26;F;68;0;3;2542;275888;15375
Hovedstaden;2021-05-26;M;295;0;4;2542;276183;15379
Midtjylland;2021-05-26;M;95;0;2;2542;276278;15381
Nordjylland;2021-05-26;M;121;0;3;2542;276399;15384
Sjælland;2021-05-26;M;77;0;1;2542;276476;15385
Syddanmark;2021-05-26;M;88;0;1;2542;276564;15386
Hovedstaden;2021-05-27;F;195;0;7;2542;276759;15393
Midtjylland;2021-05-27;F;95;0;3;2542;276854;15396
Nordjylland;2021-05-27;F;44;0;1;2542;276898;15397
Sjælland;2021-05-27;F;51;0;0;2542;276949;15397
Syddanmark;2021-05-27;F;56;0;2;2542;277005;15399
Hovedstaden;2021-05-27;M;241;0;5;2542;277246;15404
Midtjylland;2021-05-27;M;97;0;3;2542;277343;15407
Nordjylland;2021-05-27;M;64;0;2;2542;277407;15409
Sjælland;2021-05-27;M;78;1;4;2543;277485;15413
Syddanmark;2021-05-27;M;76;0;2;2543;277561;15415
Hovedstaden;2021-05-28;F;179;0;4;2543;277740;15419
Midtjylland;2021-05-28;F;80;0;1;2543;277820;15420
Nordjylland;2021-05-28;F;55;0;0;2543;277875;15420
Sjælland;2021-05-28;F;52;0;2;2543;277927;15422
Syddanmark;2021-05-28;F;67;0;1;2543;277994;15423
Hovedstaden;2021-05-28;M;194;0;4;2543;278188;15427
Midtjylland;2021-05-28;M;103;0;1;2543;278291;15428
Nordjylland;2021-05-28;M;59;0;0;2543;278350;15428
Sjælland;2021-05-28;M;60;0;0;2543;278410;15428
Syddanmark;2021-05-28;M;74;1;3;2544;278484;15431
Hovedstaden;2021-05-29;F;161;0;4;2544;278645;15435
Midtjylland;2021-05-29;F;64;0;2;2544;278709;15437
Nordjylland;2021-05-29;F;45;0;2;2544;278754;15439
Sjælland;2021-05-29;F;34;0;2;2544;278788;15441
Syddanmark;2021-05-29;F;58;0;3;2544;278846;15444
Hovedstaden;2021-05-29;M;194;1;4;2545;279040;15448
Midtjylland;2021-05-29;M;84;0;1;2545;279124;15449
Nordjylland;2021-05-29;M;66;0;0;2545;279190;15449
Sjælland;2021-05-29;M;47;0;2;2545;279237;15451
Syddanmark;2021-05-29;M;61;0;5;2545;279298;15456
Hovedstaden;2021-05-30;F;170;1;9;2546;279468;15465
Midtjylland;2021-05-30;F;76;0;0;2546;279544;15465
Nordjylland;2021-05-30;F;62;0;0;2546;279606;15465
Sjælland;2021-05-30;F;36;0;1;2546;279642;15466
Syddanmark;2021-05-30;F;52;0;2;2546;279694;15468
Hovedstaden;2021-05-30;M;167;0;5;2546;279861;15473
Midtjylland;2021-05-30;M;93;0;2;2546;279954;15475
Nordjylland;2021-05-30;M;62;0;0;2546;280016;15475
Sjælland;2021-05-30;M;46;0;0;2546;280062;15475
Syddanmark;2021-05-30;M;59;0;1;2546;280121;15476
Hovedstaden;2021-05-31;F;219;0;3;2546;280340;15479
Midtjylland;2021-05-31;F;87;0;2;2546;280427;15481
Nordjylland;2021-05-31;F;67;0;4;2546;280494;15485
Sjælland;2021-05-31;F;52;0;3;2546;280546;15488
Syddanmark;2021-05-31;F;68;0;1;2546;280614;15489
Hovedstaden;2021-05-31;M;215;0;9;2546;280829;15498
Midtjylland;2021-05-31;M;104;0;2;2546;280933;15500
Nordjylland;2021-05-31;M;87;0;1;2546;281020;15501
Sjælland;2021-05-31;M;48;0;0;2546;281068;15501
Syddanmark;2021-05-31;M;69;0;3;2546;281137;15504
Hovedstaden;2021-06-01;F;232;0;4;2546;281369;15508
Midtjylland;2021-06-01;F;101;0;4;2546;281470;15512
Nordjylland;2021-06-01;F;78;0;2;2546;281548;15514
Sjælland;2021-06-01;F;51;0;2;2546;281599;15516
Syddanmark;2021-06-01;F;70;0;1;2546;281669;15517
Hovedstaden;2021-06-01;M;267;0;2;2546;281936;15519
Midtjylland;2021-06-01;M;98;0;2;2546;282034;15521
Nordjylland;2021-06-01;M;98;0;2;2546;282132;15523
Sjælland;2021-06-01;M;50;0;6;2546;282182;15529
Syddanmark;2021-06-01;M;58;0;0;2546;282240;15529
Hovedstaden;2021-06-02;F;193;0;3;2546;282433;15532
Midtjylland;2021-06-02;F;84;0;5;2546;282517;15537
Nordjylland;2021-06-02;F;55;0;1;2546;282572;15538
Sjælland;2021-06-02;F;50;0;1;2546;282622;15539
Syddanmark;2021-06-02;F;31;0;1;2546;282653;15540
Hovedstaden;2021-06-02;M;225;1;7;2547;282878;15547
Midtjylland;2021-06-02;M;108;0;2;2547;282986;15549
Nordjylland;2021-06-02;M;85;1;3;2548;283071;15552
Sjælland;2021-06-02;M;51;0;1;2548;283122;15553
Syddanmark;2021-06-02;M;47;0;2;2548;283169;15555
Hovedstaden;2021-06-03;F;169;0;2;2548;283338;15557
Midtjylland;2021-06-03;F;66;0;1;2548;283404;15558
Nordjylland;2021-06-03;F;48;0;2;2548;283452;15560
Sjælland;2021-06-03;F;39;0;1;2548;283491;15561
Syddanmark;2021-06-03;F;30;0;0;2548;283521;15561
Hovedstaden;2021-06-03;M;180;0;1;2548;283701;15562
Midtjylland;2021-06-03;M;67;0;1;2548;283768;15563
Nordjylland;2021-06-03;M;53;0;1;2548;283821;15564
Sjælland;2021-06-03;M;63;0;2;2548;283884;15566
Syddanmark;2021-06-03;M;36;0;1;2548;283920;15567
Hovedstaden;2021-06-04;F;155;1;4;2549;284075;15571
Midtjylland;2021-06-04;F;79;0;4;2549;284154;15575
Nordjylland;2021-06-04;F;38;0;0;2549;284192;15575
Sjælland;2021-06-04;F;42;0;1;2549;284234;15576
Syddanmark;2021-06-04;F;26;0;0;2549;284260;15576
Hovedstaden;2021-06-04;M;151;0;3;2549;284411;15579
Midtjylland;2021-06-04;M;84;0;2;2549;284495;15581
Nordjylland;2021-06-04;M;45;0;1;2549;284540;15582
Sjælland;2021-06-04;M;45;0;1;2549;284585;15583
Syddanmark;2021-06-04;M;41;0;1;2549;284626;15584
Hovedstaden;2021-06-05;F;115;0;4;2549;284741;15588
Midtjylland;2021-06-05;F;73;0;1;2549;284814;15589
Nordjylland;2021-06-05;F;39;0;0;2549;284853;15589
Sjælland;2021-06-05;F;55;0;0;2549;284908;15589
Syddanmark;2021-06-05;F;14;0;0;2549;284922;15589
Hovedstaden;2021-06-05;M;123;0;4;2549;285045;15593
Midtjylland;2021-06-05;M;71;0;0;2549;285116;15593
Nordjylland;2021-06-05;M;44;0;2;2549;285160;15595
Sjælland;2021-06-05;M;49;0;1;2549;285209;15596
Syddanmark;2021-06-05;M;41;0;2;2549;285250;15598
Hovedstaden;2021-06-06;F;113;0;6;2549;285363;15604
Midtjylland;2021-06-06;F;46;0;1;2549;285409;15605
Nordjylland;2021-06-06;F;36;0;2;2549;285445;15607
Sjælland;2021-06-06;F;32;0;3;2549;285477;15610
Syddanmark;2021-06-06;F;22;0;1;2549;285499;15611
Hovedstaden;2021-06-06;M;126;0;1;2549;285625;15612
Midtjylland;2021-06-06;M;77;0;0;2549;285702;15612
Nordjylland;2021-06-06;M;41;0;0;2549;285743;15612
Sjælland;2021-06-06;M;32;0;0;2549;285775;15612
Syddanmark;2021-06-06;M;21;0;0;2549;285796;15612
Hovedstaden;2021-06-07;F;135;1;4;2550;285931;15616
Midtjylland;2021-06-07;F;67;0;1;2550;285998;15617
Nordjylland;2021-06-07;F;39;0;0;2550;286037;15617
Sjælland;2021-06-07;F;30;0;1;2550;286067;15618
Syddanmark;2021-06-07;F;42;0;2;2550;286109;15620
Hovedstaden;2021-06-07;M;137;0;5;2550;286246;15625
Midtjylland;2021-06-07;M;56;0;1;2550;286302;15626
Nordjylland;2021-06-07;M;53;0;1;2550;286355;15627
Sjælland;2021-06-07;M;30;0;1;2550;286385;15628
Syddanmark;2021-06-07;M;33;0;0;2550;286418;15628
Hovedstaden;2021-06-08;F;101;0;3;2550;286519;15631
Midtjylland;2021-06-08;F;46;0;0;2550;286565;15631
Nordjylland;2021-06-08;F;32;0;0;2550;286597;15631
Sjælland;2021-06-08;F;33;0;1;2550;286630;15632
Syddanmark;2021-06-08;F;33;0;3;2550;286663;15635
Hovedstaden;2021-06-08;M;122;0;0;2550;286785;15635
Midtjylland;2021-06-08;M;52;0;3;2550;286837;15638
Nordjylland;2021-06-08;M;28;0;1;2550;286865;15639
Sjælland;2021-06-08;M;35;0;0;2550;286900;15639
Syddanmark;2021-06-08;M;31;0;2;2550;286931;15641
Hovedstaden;2021-06-09;F;103;0;3;2550;287034;15644
Midtjylland;2021-06-09;F;49;0;0;2550;287083;15644
Nordjylland;2021-06-09;F;24;0;0;2550;287107;15644
Sjælland;2021-06-09;F;42;0;1;2550;287149;15645
Syddanmark;2021-06-09;F;22;0;2;2550;287171;15647
Hovedstaden;2021-06-09;M;92;0;4;2550;287263;15651
Midtjylland;2021-06-09;M;55;0;3;2550;287318;15654
Nordjylland;2021-06-09;M;37;0;0;2550;287355;15654
Sjælland;2021-06-09;M;30;0;0;2550;287385;15654
Syddanmark;2021-06-09;M;28;0;0;2550;287413;15654
Hovedstaden;2021-06-10;F;85;0;3;2550;287498;15657
Midtjylland;2021-06-10;F;41;0;0;2550;287539;15657
Nordjylland;2021-06-10;F;40;1;1;2551;287579;15658
Sjælland;2021-06-10;F;25;0;1;2551;287604;15659
Syddanmark;2021-06-10;F;19;0;0;2551;287623;15659
Hovedstaden;2021-06-10;M;89;0;1;2551;287712;15660
Midtjylland;2021-06-10;M;38;0;1;2551;287750;15661
Nordjylland;2021-06-10;M;27;0;0;2551;287777;15661
Sjælland;2021-06-10;M;27;0;1;2551;287804;15662
Syddanmark;2021-06-10;M;27;0;0;2551;287831;15662
Hovedstaden;2021-06-11;F;57;0;0;2551;287888;15662
Midtjylland;2021-06-11;F;35;0;1;2551;287923;15663
Nordjylland;2021-06-11;F;23;0;2;2551;287946;15665
Sjælland;2021-06-11;F;12;0;0;2551;287958;15665
Syddanmark;2021-06-11;F;17;0;0;2551;287975;15665
Hovedstaden;2021-06-11;M;68;0;3;2551;288043;15668
Midtjylland;2021-06-11;M;41;0;2;2551;288084;15670
Nordjylland;2021-06-11;M;27;0;0;2551;288111;15670
Sjælland;2021-06-11;M;22;0;0;2551;288133;15670
Syddanmark;2021-06-11;M;14;0;0;2551;288147;15670
Hovedstaden;2021-06-12;F;50;1;7;2552;288197;15677
Midtjylland;2021-06-12;F;25;0;0;2552;288222;15677
Nordjylland;2021-06-12;F;20;0;0;2552;288242;15677
Sjælland;2021-06-12;F;14;0;1;2552;288256;15678
Syddanmark;2021-06-12;F;11;0;0;2552;288267;15678
Hovedstaden;2021-06-12;M;60;0;3;2552;288327;15681
Midtjylland;2021-06-12;M;19;0;0;2552;288346;15681
Nordjylland;2021-06-12;M;16;0;0;2552;288362;15681
Sjælland;2021-06-12;M;20;0;1;2552;288382;15682
Syddanmark;2021-06-12;M;13;0;1;2552;288395;15683
Hovedstaden;2021-06-13;F;46;1;6;2553;288441;15689
Midtjylland;2021-06-13;F;25;0;0;2553;288466;15689
Nordjylland;2021-06-13;F;17;0;2;2553;288483;15691
Sjælland;2021-06-13;F;9;0;0;2553;288492;15691
Syddanmark;2021-06-13;F;19;0;1;2553;288511;15692
Hovedstaden;2021-06-13;M;41;0;1;2553;288552;15693
Midtjylland;2021-06-13;M;25;0;0;2553;288577;15693
Nordjylland;2021-06-13;M;20;0;0;2553;288597;15693
Sjælland;2021-06-13;M;15;0;1;2553;288612;15694
Syddanmark;2021-06-13;M;12;0;0;2553;288624;15694
Hovedstaden;2021-06-14;F;66;0;2;2553;288690;15696
Midtjylland;2021-06-14;F;25;0;1;2553;288715;15697
Nordjylland;2021-06-14;F;30;0;0;2553;288745;15697
Sjælland;2021-06-14;F;19;0;0;2553;288764;15697
Syddanmark;2021-06-14;F;24;0;0;2553;288788;15697
Hovedstaden;2021-06-14;M;53;0;3;2553;288841;15700
Midtjylland;2021-06-14;M;35;0;1;2553;288876;15701
Nordjylland;2021-06-14;M;19;0;0;2553;288895;15701
Sjælland;2021-06-14;M;31;0;3;2553;288926;15704
Syddanmark;2021-06-14;M;9;0;0;2553;288935;15704
Hovedstaden;2021-06-15;F;57;0;2;2553;288992;15706
Midtjylland;2021-06-15;F;36;0;0;2553;289028;15706
Nordjylland;2021-06-15;F;23;0;0;2553;289051;15706
Sjælland;2021-06-15;F;11;0;0;2553;289062;15706
Syddanmark;2021-06-15;F;15;0;1;2553;289077;15707
Hovedstaden;2021-06-15;M;70;0;3;2553;289147;15710
Midtjylland;2021-06-15;M;26;0;0;2553;289173;15710
Nordjylland;2021-06-15;M;33;0;2;2553;289206;15712
Sjælland;2021-06-15;M;18;0;0;2553;289224;15712
Syddanmark;2021-06-15;M;19;0;0;2553;289243;15712
Hovedstaden;2021-06-16;F;66;0;4;2553;289309;15716
Midtjylland;2021-06-16;F;29;0;0;2553;289338;15716
Nordjylland;2021-06-16;F;11;0;0;2553;289349;15716
Sjælland;2021-06-16;F;23;0;0;2553;289372;15716
Syddanmark;2021-06-16;F;12;0;0;2553;289384;15716
Hovedstaden;2021-06-16;M;77;0;4;2553;289461;15720
Midtjylland;2021-06-16;M;31;0;1;2553;289492;15721
Nordjylland;2021-06-16;M;12;0;0;2553;289504;15721
Sjælland;2021-06-16;M;13;0;0;2553;289517;15721
Syddanmark;2021-06-16;M;13;0;0;2553;289530;15721
Hovedstaden;2021-06-17;F;49;0;0;2553;289579;15721
Midtjylland;2021-06-17;F;17;0;0;2553;289596;15721
Nordjylland;2021-06-17;F;19;0;1;2553;289615;15722
Sjælland;2021-06-17;F;16;0;3;2553;289631;15725
Syddanmark;2021-06-17;F;3;0;0;2553;289634;15725
Hovedstaden;2021-06-17;M;53;0;1;2553;289687;15726
Midtjylland;2021-06-17;M;20;0;0;2553;289707;15726
Nordjylland;2021-06-17;M;10;0;0;2553;289717;15726
Sjælland;2021-06-17;M;14;0;0;2553;289731;15726
Syddanmark;2021-06-17;M;12;0;1;2553;289743;15727
Hovedstaden;2021-06-18;F;46;0;0;2553;289789;15727
Midtjylland;2021-06-18;F;14;0;1;2553;289803;15728
Nordjylland;2021-06-18;F;14;0;0;2553;289817;15728
Sjælland;2021-06-18;F;9;0;0;2553;289826;15728
Syddanmark;2021-06-18;F;3;0;0;2553;289829;15728
Hovedstaden;2021-06-18;M;52;0;4;2553;289881;15732
Midtjylland;2021-06-18;M;29;0;0;2553;289910;15732
Nordjylland;2021-06-18;M;15;1;3;2554;289925;15735
Sjælland;2021-06-18;M;14;0;0;2554;289939;15735
Syddanmark;2021-06-18;M;7;0;0;2554;289946;15735
Hovedstaden;2021-06-19;F;39;0;1;2554;289985;15736
Midtjylland;2021-06-19;F;9;0;0;2554;289994;15736
Nordjylland;2021-06-19;F;10;1;2;2555;290004;15738
Sjælland;2021-06-19;F;12;0;0;2555;290016;15738
Syddanmark;2021-06-19;F;7;0;0;2555;290023;15738
Hovedstaden;2021-06-19;M;55;0;3;2555;290078;15741
Midtjylland;2021-06-19;M;12;0;0;2555;290090;15741
Nordjylland;2021-06-19;M;12;1;2;2556;290102;15743
Sjælland;2021-06-19;M;10;0;1;2556;290112;15744
Syddanmark;2021-06-19;M;7;0;0;2556;290119;15744
Hovedstaden;2021-06-20;F;42;0;2;2556;290161;15746
Midtjylland;2021-06-20;F;16;0;0;2556;290177;15746
Nordjylland;2021-06-20;F;9;0;0;2556;290186;15746
Sjælland;2021-06-20;F;6;0;2;2556;290192;15748
Syddanmark;2021-06-20;F;5;0;1;2556;290197;15749
Hovedstaden;2021-06-20;M;37;0;0;2556;290234;15749
Midtjylland;2021-06-20;M;23;0;2;2556;290257;15751
Nordjylland;2021-06-20;M;8;0;0;2556;290265;15751
Sjælland;2021-06-20;M;10;0;1;2556;290275;15752
Syddanmark;2021-06-20;M;5;0;0;2556;290280;15752
Hovedstaden;2021-06-21;F;45;0;2;2556;290325;15754
Midtjylland;2021-06-21;F;12;0;1;2556;290337;15755
Nordjylland;2021-06-21;F;5;0;1;2556;290342;15756
Sjælland;2021-06-21;F;4;0;0;2556;290346;15756
Syddanmark;2021-06-21;F;8;0;1;2556;290354;15757
Hovedstaden;2021-06-21;M;63;0;2;2556;290417;15759
Midtjylland;2021-06-21;M;17;0;0;2556;290434;15759
Nordjylland;2021-06-21;M;12;0;0;2556;290446;15759
Sjælland;2021-06-21;M;6;0;0;2556;290452;15759
Syddanmark;2021-06-21;M;17;0;0;2556;290469;15759
Hovedstaden;2021-06-22;F;47;0;1;2556;290516;15760
Midtjylland;2021-06-22;F;9;0;0;2556;290525;15760
Nordjylland;2021-06-22;F;10;0;0;2556;290535;15760
Sjælland;2021-06-22;F;4;0;1;2556;290539;15761
Syddanmark;2021-06-22;F;4;0;0;2556;290543;15761
Hovedstaden;2021-06-22;M;54;0;1;2556;290597;15762
Midtjylland;2021-06-22;M;12;0;0;2556;290609;15762
Nordjylland;2021-06-22;M;4;0;0;2556;290613;15762
Sjælland;2021-06-22;M;14;0;0;2556;290627;15762
Syddanmark;2021-06-22;M;17;0;0;2556;290644;15762
Hovedstaden;2021-06-23;F;49;0;1;2556;290693;15763
Midtjylland;2021-06-23;F;16;0;2;2556;290709;15765
Nordjylland;2021-06-23;F;21;0;1;2556;290730;15766
Sjælland;2021-06-23;F;6;0;0;2556;290736;15766
Syddanmark;2021-06-23;F;8;0;0;2556;290744;15766
Hovedstaden;2021-06-23;M;49;0;4;2556;290793;15770
Midtjylland;2021-06-23;M;21;0;0;2556;290814;15770
Nordjylland;2021-06-23;M;13;0;0;2556;290827;15770
Sjælland;2021-06-23;M;11;0;2;2556;290838;15772
Syddanmark;2021-06-23;M;12;0;1;2556;290850;15773
Hovedstaden;2021-06-24;F;53;0;1;2556;290903;15774
Midtjylland;2021-06-24;F;15;0;0;2556;290918;15774
Nordjylland;2021-06-24;F;8;0;0;2556;290926;15774
Sjælland;2021-06-24;F;8;0;1;2556;290934;15775
Syddanmark;2021-06-24;F;15;0;0;2556;290949;15775
Hovedstaden;2021-06-24;M;57;0;2;2556;291006;15777
Midtjylland;2021-06-24;M;27;0;0;2556;291033;15777
Nordjylland;2021-06-24;M;13;0;0;2556;291046;15777
Sjælland;2021-06-24;M;4;0;0;2556;291050;15777
Syddanmark;2021-06-24;M;13;0;1;2556;291063;15778
Hovedstaden;2021-06-25;F;40;0;1;2556;291103;15779
Midtjylland;2021-06-25;F;13;0;0;2556;291116;15779
Nordjylland;2021-06-25;F;6;0;0;2556;291122;15779
Sjælland;2021-06-25;F;10;0;1;2556;291132;15780
Syddanmark;2021-06-25;F;7;0;0;2556;291139;15780
Hovedstaden;2021-06-25;M;58;0;5;2556;291197;15785
Midtjylland;2021-06-25;M;23;0;1;2556;291220;15786
Nordjylland;2021-06-25;M;14;0;0;2556;291234;15786
Sjælland;2021-06-25;M;9;0;0;2556;291243;15786
Syddanmark;2021-06-25;M;11;0;0;2556;291254;15786
Hovedstaden;2021-06-26;F;44;0;4;2556;291298;15790
Midtjylland;2021-06-26;F;9;0;1;2556;291307;15791
Nordjylland;2021-06-26;F;5;0;0;2556;291312;15791
Sjælland;2021-06-26;F;2;0;0;2556;291314;15791
Syddanmark;2021-06-26;F;4;0;0;2556;291318;15791
Hovedstaden;2021-06-26;M;49;0;2;2556;291367;15793
Midtjylland;2021-06-26;M;7;0;0;2556;291374;15793
Nordjylland;2021-06-26;M;8;0;0;2556;291382;15793
Sjælland;2021-06-26;M;5;0;0;2556;291387;15793
Syddanmark;2021-06-26;M;11;0;0;2556;291398;15793
Hovedstaden;2021-06-27;F;65;0;1;2556;291463;15794
Midtjylland;2021-06-27;F;8;0;0;2556;291471;15794
Nordjylland;2021-06-27;F;8;0;0;2556;291479;15794
Sjælland;2021-06-27;F;3;0;0;2556;291482;15794
Syddanmark;2021-06-27;F;10;0;0;2556;291492;15794
Hovedstaden;2021-06-27;M;52;1;1;2557;291544;15795
Midtjylland;2021-06-27;M;11;0;1;2557;291555;15796
Nordjylland;2021-06-27;M;13;0;0;2557;291568;15796
Sjælland;2021-06-27;M;8;0;0;2557;291576;15796
Syddanmark;2021-06-27;M;8;0;0;2557;291584;15796
Hovedstaden;2021-06-28;F;86;0;1;2557;291670;15797
Midtjylland;2021-06-28;F;20;0;0;2557;291690;15797
Nordjylland;2021-06-28;F;17;0;0;2557;291707;15797
Sjælland;2021-06-28;F;6;0;1;2557;291713;15798
Syddanmark;2021-06-28;F;9;0;0;2557;291722;15798
Hovedstaden;2021-06-28;M;85;0;2;2557;291807;15800
Midtjylland;2021-06-28;M;21;0;0;2557;291828;15800
Nordjylland;2021-06-28;M;21;0;0;2557;291849;15800
Sjælland;2021-06-28;M;15;0;0;2557;291864;15800
Syddanmark;2021-06-28;M;9;0;0;2557;291873;15800
Hovedstaden;2021-06-29;F;118;0;0;2557;291991;15800
Midtjylland;2021-06-29;F;19;0;0;2557;292010;15800
Nordjylland;2021-06-29;F;22;0;0;2557;292032;15800
Sjælland;2021-06-29;F;25;0;0;2557;292057;15800
Syddanmark;2021-06-29;F;14;0;0;2557;292071;15800
Hovedstaden;2021-06-29;M;133;0;2;2557;292204;15802
Midtjylland;2021-06-29;M;18;0;1;2557;292222;15803
Nordjylland;2021-06-29;M;22;0;0;2557;292244;15803
Sjælland;2021-06-29;M;21;0;2;2557;292265;15805
Syddanmark;2021-06-29;M;6;0;0;2557;292271;15805
Hovedstaden;2021-06-30;F;130;0;2;2557;292401;15807
Midtjylland;2021-06-30;F;30;0;1;2557;292431;15808
Nordjylland;2021-06-30;F;11;0;0;2557;292442;15808
Sjælland;2021-06-30;F;19;0;0;2557;292461;15808
Syddanmark;2021-06-30;F;15;0;0;2557;292476;15808
Hovedstaden;2021-06-30;M;182;0;4;2557;292658;15812
Midtjylland;2021-06-30;M;28;0;2;2557;292686;15814
Nordjylland;2021-06-30;M;20;0;0;2557;292706;15814
Sjælland;2021-06-30;M;28;0;0;2557;292734;15814
Syddanmark;2021-06-30;M;17;0;1;2557;292751;15815
Hovedstaden;2021-07-01;F;87;0;0;2557;292838;15815
Midtjylland;2021-07-01;F;28;0;1;2557;292866;15816
Nordjylland;2021-07-01;F;11;0;2;2557;292877;15818
Sjælland;2021-07-01;F;30;0;4;2557;292907;15822
Syddanmark;2021-07-01;F;16;0;0;2557;292923;15822
Hovedstaden;2021-07-01;M;122;0;4;2557;293045;15826
Midtjylland;2021-07-01;M;17;0;0;2557;293062;15826
Nordjylland;2021-07-01;M;16;0;0;2557;293078;15826
Sjælland;2021-07-01;M;34;0;2;2557;293112;15828
Syddanmark;2021-07-01;M;25;0;0;2557;293137;15828
Hovedstaden;2021-07-02;F;89;0;2;2557;293226;15830
Midtjylland;2021-07-02;F;26;1;1;2558;293252;15831
Nordjylland;2021-07-02;F;10;0;0;2558;293262;15831
Sjælland;2021-07-02;F;12;0;0;2558;293274;15831
Syddanmark;2021-07-02;F;14;0;0;2558;293288;15831
Hovedstaden;2021-07-02;M;135;0;2;2558;293423;15833
Midtjylland;2021-07-02;M;27;0;0;2558;293450;15833
Nordjylland;2021-07-02;M;16;0;0;2558;293466;15833
Sjælland;2021-07-02;M;26;0;1;2558;293492;15834
Syddanmark;2021-07-02;M;18;0;0;2558;293510;15834
Hovedstaden;2021-07-03;F;83;0;1;2558;293593;15835
Midtjylland;2021-07-03;F;24;0;0;2558;293617;15835
Nordjylland;2021-07-03;F;9;0;0;2558;293626;15835
Sjælland;2021-07-03;F;20;0;2;2558;293646;15837
Syddanmark;2021-07-03;F;11;0;0;2558;293657;15837
Hovedstaden;2021-07-03;M;103;1;2;2559;293760;15839
Midtjylland;2021-07-03;M;30;0;1;2559;293790;15840
Nordjylland;2021-07-03;M;28;0;0;2559;293818;15840
Sjælland;2021-07-03;M;26;0;0;2559;293844;15840
Syddanmark;2021-07-03;M;21;0;0;2559;293865;15840
Hovedstaden;2021-07-04;F;103;0;2;2559;293968;15842
Midtjylland;2021-07-04;F;29;0;2;2559;293997;15844
Nordjylland;2021-07-04;F;13;0;0;2559;294010;15844
Sjælland;2021-07-04;F;15;0;0;2559;294025;15844
Syddanmark;2021-07-04;F;23;0;0;2559;294048;15844
Hovedstaden;2021-07-04;M;125;0;2;2559;294173;15846
Midtjylland;2021-07-04;M;35;1;2;2560;294208;15848
Nordjylland;2021-07-04;M;15;0;0;2560;294223;15848
Sjælland;2021-07-04;M;25;0;1;2560;294248;15849
Syddanmark;2021-07-04;M;22;0;0;2560;294270;15849
Hovedstaden;2021-07-05;F;159;1;5;2561;294429;15854
Midtjylland;2021-07-05;F;68;0;0;2561;294497;15854
Nordjylland;2021-07-05;F;18;0;0;2561;294515;15854
Sjælland;2021-07-05;F;27;0;0;2561;294542;15854
Syddanmark;2021-07-05;F;51;0;1;2561;294593;15855
Hovedstaden;2021-07-05;M;153;0;4;2561;294746;15859
Midtjylland;2021-07-05;M;83;0;1;2561;294829;15860
Nordjylland;2021-07-05;M;28;0;0;2561;294857;15860
Sjælland;2021-07-05;M;31;0;0;2561;294888;15860
Syddanmark;2021-07-05;M;59;0;1;2561;294947;15861
Hovedstaden;2021-07-06;F;169;0;7;2561;295116;15868
Midtjylland;2021-07-06;F;60;0;2;2561;295176;15870
Nordjylland;2021-07-06;F;16;0;0;2561;295192;15870
Sjælland;2021-07-06;F;31;0;2;2561;295223;15872
Syddanmark;2021-07-06;F;47;0;0;2561;295270;15872
Hovedstaden;2021-07-06;M;183;0;4;2561;295453;15876
Midtjylland;2021-07-06;M;56;0;1;2561;295509;15877
Nordjylland;2021-07-06;M;18;0;0;2561;295527;15877
Sjælland;2021-07-06;M;20;0;1;2561;295547;15878
Syddanmark;2021-07-06;M;60;0;1;2561;295607;15879
Hovedstaden;2021-07-07;F;132;0;3;2561;295739;15882
Midtjylland;2021-07-07;F;66;0;1;2561;295805;15883
Nordjylland;2021-07-07;F;22;0;1;2561;295827;15884
Sjælland;2021-07-07;F;25;0;1;2561;295852;15885
Syddanmark;2021-07-07;F;38;0;0;2561;295890;15885
Hovedstaden;2021-07-07;M;167;0;2;2561;296057;15887
Midtjylland;2021-07-07;M;77;0;1;2561;296134;15888
Nordjylland;2021-07-07;M;14;0;0;2561;296148;15888
Sjælland;2021-07-07;M;32;0;3;2561;296180;15891
Syddanmark;2021-07-07;M;45;0;0;2561;296225;15891
Hovedstaden;2021-07-08;F;131;0;3;2561;296356;15894
Midtjylland;2021-07-08;F;59;0;2;2561;296415;15896
Nordjylland;2021-07-08;F;16;0;0;2561;296431;15896
Sjælland;2021-07-08;F;24;0;0;2561;296455;15896
Syddanmark;2021-07-08;F;26;0;3;2561;296481;15899
Hovedstaden;2021-07-08;M;144;0;3;2561;296625;15902
Midtjylland;2021-07-08;M;61;0;0;2561;296686;15902
Nordjylland;2021-07-08;M;19;0;1;2561;296705;15903
Sjælland;2021-07-08;M;29;0;0;2561;296734;15903
Syddanmark;2021-07-08;M;34;0;0;2561;296768;15903
Hovedstaden;2021-07-09;F;137;0;3;2561;296905;15906
Midtjylland;2021-07-09;F;65;0;2;2561;296970;15908
Nordjylland;2021-07-09;F;9;0;1;2561;296979;15909
Sjælland;2021-07-09;F;14;0;1;2561;296993;15910
Syddanmark;2021-07-09;F;26;0;1;2561;297019;15911
Hovedstaden;2021-07-09;M;167;0;1;2561;297186;15912
Midtjylland;2021-07-09;M;63;0;0;2561;297249;15912
Nordjylland;2021-07-09;M;18;0;0;2561;297267;15912
Sjælland;2021-07-09;M;34;0;0;2561;297301;15912
Syddanmark;2021-07-09;M;34;0;0;2561;297335;15912
Hovedstaden;2021-07-10;F;167;0;1;2561;297502;15913
Midtjylland;2021-07-10;F;64;0;0;2561;297566;15913
Nordjylland;2021-07-10;F;13;0;0;2561;297579;15913
Sjælland;2021-07-10;F;26;0;1;2561;297605;15914
Syddanmark;2021-07-10;F;44;0;0;2561;297649;15914
Hovedstaden;2021-07-10;M;186;0;3;2561;297835;15917
Midtjylland;2021-07-10;M;65;0;0;2561;297900;15917
Nordjylland;2021-07-10;M;20;0;0;2561;297920;15917
Sjælland;2021-07-10;M;36;0;0;2561;297956;15917
Syddanmark;2021-07-10;M;34;0;0;2561;297990;15917
Hovedstaden;2021-07-11;F;193;0;5;2561;298183;15922
Midtjylland;2021-07-11;F;84;0;3;2561;298267;15925
Nordjylland;2021-07-11;F;12;0;1;2561;298279;15926
Sjælland;2021-07-11;F;31;0;0;2561;298310;15926
Syddanmark;2021-07-11;F;55;0;2;2561;298365;15928
Hovedstaden;2021-07-11;M;291;0;5;2561;298656;15933
Midtjylland;2021-07-11;M;126;0;3;2561;298782;15936
Nordjylland;2021-07-11;M;29;0;0;2561;298811;15936
Sjælland;2021-07-11;M;32;0;0;2561;298843;15936
Syddanmark;2021-07-11;M;70;0;2;2561;298913;15938
Hovedstaden;2021-07-12;F;272;0;3;2561;299185;15941
Midtjylland;2021-07-12;F;111;0;3;2561;299296;15944
Nordjylland;2021-07-12;F;22;0;0;2561;299318;15944
Sjælland;2021-07-12;F;39;0;1;2561;299357;15945
Syddanmark;2021-07-12;F;54;1;1;2562;299411;15946
Hovedstaden;2021-07-12;M;305;0;4;2562;299716;15950
Midtjylland;2021-07-12;M;153;0;3;2562;299869;15953
Nordjylland;2021-07-12;M;23;0;1;2562;299892;15954
Sjælland;2021-07-12;M;45;0;2;2562;299937;15956
Syddanmark;2021-07-12;M;88;1;4;2563;300025;15960
Hovedstaden;2021-07-13;F;296;0;0;2563;300321;15960
Midtjylland;2021-07-13;F;121;1;3;2564;300442;15963
Nordjylland;2021-07-13;F;22;0;0;2564;300464;15963
Sjælland;2021-07-13;F;40;0;1;2564;300504;15964
Syddanmark;2021-07-13;F;59;0;2;2564;300563;15966
Hovedstaden;2021-07-13;M;344;0;6;2564;300907;15972
Midtjylland;2021-07-13;M;150;0;0;2564;301057;15972
Nordjylland;2021-07-13;M;30;0;0;2564;301087;15972
Sjælland;2021-07-13;M;56;0;1;2564;301143;15973
Syddanmark;2021-07-13;M;100;0;2;2564;301243;15975
Hovedstaden;2021-07-14;F;281;0;3;2564;301524;15978
Midtjylland;2021-07-14;F;140;0;1;2564;301664;15979
Nordjylland;2021-07-14;F;20;0;0;2564;301684;15979
Sjælland;2021-07-14;F;50;0;3;2564;301734;15982
Syddanmark;2021-07-14;F;50;0;1;2564;301784;15983
Hovedstaden;2021-07-14;M;331;0;4;2564;302115;15987
Midtjylland;2021-07-14;M;159;0;2;2564;302274;15989
Nordjylland;2021-07-14;M;25;0;1;2564;302299;15990
Sjælland;2021-07-14;M;53;0;1;2564;302352;15991
Syddanmark;2021-07-14;M;81;0;1;2564;302433;15992
Hovedstaden;2021-07-15;F;261;0;3;2564;302694;15995
Midtjylland;2021-07-15;F;101;0;3;2564;302795;15998
Nordjylland;2021-07-15;F;27;0;0;2564;302822;15998
Sjælland;2021-07-15;F;37;0;0;2564;302859;15998
Syddanmark;2021-07-15;F;55;0;1;2564;302914;15999
Hovedstaden;2021-07-15;M;295;0;6;2564;303209;16005
Midtjylland;2021-07-15;M;138;0;3;2564;303347;16008
Nordjylland;2021-07-15;M;18;0;0;2564;303365;16008
Sjælland;2021-07-15;M;40;0;4;2564;303405;16012
Syddanmark;2021-07-15;M;65;1;0;2565;303470;16012
Hovedstaden;2021-07-16;F;174;0;3;2565;303644;16015
Midtjylland;2021-07-16;F;97;0;1;2565;303741;16016
Nordjylland;2021-07-16;F;12;0;0;2565;303753;16016
Sjælland;2021-07-16;F;38;0;1;2565;303791;16017
Syddanmark;2021-07-16;F;47;0;2;2565;303838;16019
Hovedstaden;2021-07-16;M;232;1;3;2566;304070;16022
Midtjylland;2021-07-16;M;101;0;1;2566;304171;16023
Nordjylland;2021-07-16;M;21;0;0;2566;304192;16023
Sjælland;2021-07-16;M;43;0;0;2566;304235;16023
Syddanmark;2021-07-16;M;44;0;0;2566;304279;16023
Hovedstaden;2021-07-17;F;182;0;2;2566;304461;16025
Midtjylland;2021-07-17;F;90;1;3;2567;304551;16028
Nordjylland;2021-07-17;F;15;0;0;2567;304566;16028
Sjælland;2021-07-17;F;31;0;2;2567;304597;16030
Syddanmark;2021-07-17;F;47;0;0;2567;304644;16030
Hovedstaden;2021-07-17;M;205;0;4;2567;304849;16034
Midtjylland;2021-07-17;M;82;0;0;2567;304931;16034
Nordjylland;2021-07-17;M;28;0;0;2567;304959;16034
Sjælland;2021-07-17;M;43;0;1;2567;305002;16035
Syddanmark;2021-07-17;M;55;0;0;2567;305057;16035
Hovedstaden;2021-07-18;F;158;0;2;2567;305215;16037
Midtjylland;2021-07-18;F;78;0;0;2567;305293;16037
Nordjylland;2021-07-18;F;15;0;0;2567;305308;16037
Sjælland;2021-07-18;F;33;0;0;2567;305341;16037
Syddanmark;2021-07-18;F;51;0;1;2567;305392;16038
Hovedstaden;2021-07-18;M;169;0;2;2567;305561;16040
Midtjylland;2021-07-18;M;84;0;0;2567;305645;16040
Nordjylland;2021-07-18;M;24;0;0;2567;305669;16040
Sjælland;2021-07-18;M;58;1;1;2568;305727;16041
Syddanmark;2021-07-18;M;52;0;1;2568;305779;16042
Hovedstaden;2021-07-19;F;183;0;1;2568;305962;16043
Midtjylland;2021-07-19;F;114;0;3;2568;306076;16046
Nordjylland;2021-07-19;F;29;0;0;2568;306105;16046
Sjælland;2021-07-19;F;39;0;3;2568;306144;16049
Syddanmark;2021-07-19;F;48;0;2;2568;306192;16051
Hovedstaden;2021-07-19;M;206;1;3;2569;306398;16054
Midtjylland;2021-07-19;M;123;0;1;2569;306521;16055
Nordjylland;2021-07-19;M;31;0;0;2569;306552;16055
Sjælland;2021-07-19;M;34;0;1;2569;306586;16056
Syddanmark;2021-07-19;M;46;0;1;2569;306632;16057
Hovedstaden;2021-07-20;F;184;0;5;2569;306816;16062
Midtjylland;2021-07-20;F;78;0;1;2569;306894;16063
Nordjylland;2021-07-20;F;18;0;0;2569;306912;16063
Sjælland;2021-07-20;F;24;0;0;2569;306936;16063
Syddanmark;2021-07-20;F;56;0;2;2569;306992;16065
Hovedstaden;2021-07-20;M;210;0;3;2569;307202;16068
Midtjylland;2021-07-20;M;119;0;2;2569;307321;16070
Nordjylland;2021-07-20;M;17;0;0;2569;307338;16070
Sjælland;2021-07-20;M;37;0;0;2569;307375;16070
Syddanmark;2021-07-20;M;66;0;0;2569;307441;16070
Hovedstaden;2021-07-21;F;199;0;5;2569;307640;16075
Midtjylland;2021-07-21;F;81;0;0;2569;307721;16075
Nordjylland;2021-07-21;F;28;0;0;2569;307749;16075
Sjælland;2021-07-21;F;32;0;0;2569;307781;16075
Syddanmark;2021-07-21;F;42;0;0;2569;307823;16075
Hovedstaden;2021-07-21;M;173;1;2;2570;307996;16077
Midtjylland;2021-07-21;M;119;0;3;2570;308115;16080
Nordjylland;2021-07-21;M;32;0;1;2570;308147;16081
Sjælland;2021-07-21;M;35;0;2;2570;308182;16083
Syddanmark;2021-07-21;M;59;0;0;2570;308241;16083
Hovedstaden;2021-07-22;F;129;0;2;2570;308370;16085
Midtjylland;2021-07-22;F;91;0;2;2570;308461;16087
Nordjylland;2021-07-22;F;28;0;0;2570;308489;16087
Sjælland;2021-07-22;F;35;0;0;2570;308524;16087
Syddanmark;2021-07-22;F;47;0;1;2570;308571;16088
Hovedstaden;2021-07-22;M;169;0;3;2570;308740;16091
Midtjylland;2021-07-22;M;91;0;3;2570;308831;16094
Nordjylland;2021-07-22;M;22;0;1;2570;308853;16095
Sjælland;2021-07-22;M;34;0;1;2570;308887;16096
Syddanmark;2021-07-22;M;54;0;2;2570;308941;16098
Hovedstaden;2021-07-23;F;141;1;4;2571;309082;16102
Midtjylland;2021-07-23;F;94;0;3;2571;309176;16105
Nordjylland;2021-07-23;F;19;0;0;2571;309195;16105
Sjælland;2021-07-23;F;29;0;1;2571;309224;16106
Syddanmark;2021-07-23;F;52;0;0;2571;309276;16106
Hovedstaden;2021-07-23;M;161;2;5;2573;309437;16111
Midtjylland;2021-07-23;M;102;0;0;2573;309539;16111
Nordjylland;2021-07-23;M;27;0;1;2573;309566;16112
Sjælland;2021-07-23;M;34;1;2;2574;309600;16114
Syddanmark;2021-07-23;M;73;0;0;2574;309673;16114
Hovedstaden;2021-07-24;F;136;0;4;2574;309809;16118
Midtjylland;2021-07-24;F;81;0;1;2574;309890;16119
Nordjylland;2021-07-24;F;27;0;0;2574;309917;16119
Sjælland;2021-07-24;F;27;0;4;2574;309944;16123
Syddanmark;2021-07-24;F;28;0;1;2574;309972;16124
Hovedstaden;2021-07-24;M;132;0;3;2574;310104;16127
Midtjylland;2021-07-24;M;103;0;1;2574;310207;16128
Nordjylland;2021-07-24;M;31;0;0;2574;310238;16128
Sjælland;2021-07-24;M;22;0;0;2574;310260;16128
Syddanmark;2021-07-24;M;48;0;0;2574;310308;16128
Hovedstaden;2021-07-25;F;145;0;5;2574;310453;16133
Midtjylland;2021-07-25;F;93;0;0;2574;310546;16133
Nordjylland;2021-07-25;F;23;0;0;2574;310569;16133
Sjælland;2021-07-25;F;26;0;1;2574;310595;16134
Syddanmark;2021-07-25;F;59;0;2;2574;310654;16136
Hovedstaden;2021-07-25;M;203;0;4;2574;310857;16140
Midtjylland;2021-07-25;M;107;1;2;2575;310964;16142
Nordjylland;2021-07-25;M;32;0;0;2575;310996;16142
Sjælland;2021-07-25;M;27;0;2;2575;311023;16144
Syddanmark;2021-07-25;M;56;0;0;2575;311079;16144
Hovedstaden;2021-07-26;F;193;0;4;2575;311272;16148
Midtjylland;2021-07-26;F;126;0;0;2575;311398;16148
Nordjylland;2021-07-26;F;46;0;0;2575;311444;16148
Sjælland;2021-07-26;F;51;0;0;2575;311495;16148
Syddanmark;2021-07-26;F;70;0;5;2575;311565;16153
Hovedstaden;2021-07-26;M;213;0;1;2575;311778;16154
Midtjylland;2021-07-26;M;150;0;2;2575;311928;16156
Nordjylland;2021-07-26;M;62;0;0;2575;311990;16156
Sjælland;2021-07-26;M;39;0;2;2575;312029;16158
Syddanmark;2021-07-26;M;79;0;0;2575;312108;16158
Hovedstaden;2021-07-27;F;207;0;5;2575;312315;16163
Midtjylland;2021-07-27;F;119;1;0;2576;312434;16163
Nordjylland;2021-07-27;F;60;0;0;2576;312494;16163
Sjælland;2021-07-27;F;31;0;0;2576;312525;16163
Syddanmark;2021-07-27;F;55;0;0;2576;312580;16163
Hovedstaden;2021-07-27;M;192;0;2;2576;312772;16165
Midtjylland;2021-07-27;M;134;1;1;2577;312906;16166
Nordjylland;2021-07-27;M;66;0;0;2577;312972;16166
Sjælland;2021-07-27;M;40;0;2;2577;313012;16168
Syddanmark;2021-07-27;M;62;0;2;2577;313074;16170
Hovedstaden;2021-07-28;F;189;0;7;2577;313263;16177
Midtjylland;2021-07-28;F;108;0;3;2577;313371;16180
Nordjylland;2021-07-28;F;81;0;0;2577;313452;16180
Sjælland;2021-07-28;F;33;0;1;2577;313485;16181
Syddanmark;2021-07-28;F;62;0;0;2577;313547;16181
Hovedstaden;2021-07-28;M;193;0;7;2577;313740;16188
Midtjylland;2021-07-28;M;109;0;0;2577;313849;16188
Nordjylland;2021-07-28;M;80;0;0;2577;313929;16188
Sjælland;2021-07-28;M;36;0;2;2577;313965;16190
Syddanmark;2021-07-28;M;94;1;3;2578;314059;16193
Hovedstaden;2021-07-29;F;161;0;3;2578;314220;16196
Midtjylland;2021-07-29;F;103;0;2;2578;314323;16198
Nordjylland;2021-07-29;F;55;0;2;2578;314378;16200
Sjælland;2021-07-29;F;25;0;0;2578;314403;16200
Syddanmark;2021-07-29;F;75;0;4;2578;314478;16204
Hovedstaden;2021-07-29;M;154;0;4;2578;314632;16208
Midtjylland;2021-07-29;M;122;0;2;2578;314754;16210
Nordjylland;2021-07-29;M;72;0;0;2578;314826;16210
Sjælland;2021-07-29;M;36;0;1;2578;314862;16211
Syddanmark;2021-07-29;M;84;0;2;2578;314946;16213
Hovedstaden;2021-07-30;F;169;0;3;2578;315115;16216
Midtjylland;2021-07-30;F;92;0;2;2578;315207;16218
Nordjylland;2021-07-30;F;41;0;0;2578;315248;16218
Sjælland;2021-07-30;F;39;0;0;2578;315287;16218
Syddanmark;2021-07-30;F;57;1;0;2579;315344;16218
Hovedstaden;2021-07-30;M;177;1;10;2580;315521;16228
Midtjylland;2021-07-30;M;120;0;0;2580;315641;16228
Nordjylland;2021-07-30;M;48;0;1;2580;315689;16229
Sjælland;2021-07-30;M;39;0;2;2580;315728;16231
Syddanmark;2021-07-30;M;65;0;1;2580;315793;16232
Hovedstaden;2021-07-31;F;156;0;2;2580;315949;16234
Midtjylland;2021-07-31;F;89;0;2;2580;316038;16236
Nordjylland;2021-07-31;F;44;0;0;2580;316082;16236
Sjælland;2021-07-31;F;30;0;1;2580;316112;16237
Syddanmark;2021-07-31;F;57;0;2;2580;316169;16239
Hovedstaden;2021-07-31;M;135;0;1;2580;316304;16240
Midtjylland;2021-07-31;M;91;0;1;2580;316395;16241
Nordjylland;2021-07-31;M;71;0;0;2580;316466;16241
Sjælland;2021-07-31;M;25;0;1;2580;316491;16242
Syddanmark;2021-07-31;M;52;0;1;2580;316543;16243
Hovedstaden;2021-08-01;F;155;0;3;2580;316698;16246
Midtjylland;2021-08-01;F;86;0;2;2580;316784;16248
Nordjylland;2021-08-01;F;67;0;0;2580;316851;16248
Sjælland;2021-08-01;F;51;1;4;2581;316902;16252
Syddanmark;2021-08-01;F;57;0;2;2581;316959;16254
Hovedstaden;2021-08-01;M;180;0;2;2581;317139;16256
Midtjylland;2021-08-01;M;95;0;3;2581;317234;16259
Nordjylland;2021-08-01;M;48;0;0;2581;317282;16259
Sjælland;2021-08-01;M;26;0;0;2581;317308;16259
Syddanmark;2021-08-01;M;71;0;4;2581;317379;16263
Hovedstaden;2021-08-02;F;165;0;4;2581;317544;16267
Midtjylland;2021-08-02;F;108;0;3;2581;317652;16270
Nordjylland;2021-08-02;F;55;0;0;2581;317707;16270
Sjælland;2021-08-02;F;36;0;0;2581;317743;16270
Syddanmark;2021-08-02;F;69;0;3;2581;317812;16273
Hovedstaden;2021-08-02;M;175;0;7;2581;317987;16280
Midtjylland;2021-08-02;M;122;0;0;2581;318109;16280
Nordjylland;2021-08-02;M;59;0;0;2581;318168;16280
Sjælland;2021-08-02;M;42;1;2;2582;318210;16282
Syddanmark;2021-08-02;M;79;0;2;2582;318289;16284
Hovedstaden;2021-08-03;F;151;0;6;2582;318440;16290
Midtjylland;2021-08-03;F;116;0;4;2582;318556;16294
Nordjylland;2021-08-03;F;38;0;0;2582;318594;16294
Sjælland;2021-08-03;F;48;0;1;2582;318642;16295
Syddanmark;2021-08-03;F;69;0;1;2582;318711;16296
Hovedstaden;2021-08-03;M;155;0;3;2582;318866;16299
Midtjylland;2021-08-03;M;129;0;2;2582;318995;16301
Nordjylland;2021-08-03;M;51;0;0;2582;319046;16301
Sjælland;2021-08-03;M;45;0;0;2582;319091;16301
Syddanmark;2021-08-03;M;83;0;4;2582;319174;16305
Hovedstaden;2021-08-04;F;183;0;7;2582;319357;16312
Midtjylland;2021-08-04;F;95;0;3;2582;319452;16315
Nordjylland;2021-08-04;F;52;0;3;2582;319504;16318
Sjælland;2021-08-04;F;30;1;1;2583;319534;16319
Syddanmark;2021-08-04;F;82;0;0;2583;319616;16319
Hovedstaden;2021-08-04;M;170;0;4;2583;319786;16323
Midtjylland;2021-08-04;M;120;0;3;2583;319906;16326
Nordjylland;2021-08-04;M;61;0;0;2583;319967;16326
Sjælland;2021-08-04;M;39;0;0;2583;320006;16326
Syddanmark;2021-08-04;M;90;0;3;2583;320096;16329
Hovedstaden;2021-08-05;F;173;0;6;2583;320269;16335
Midtjylland;2021-08-05;F;98;0;1;2583;320367;16336
Nordjylland;2021-08-05;F;60;0;1;2583;320427;16337
Sjælland;2021-08-05;F;33;1;1;2584;320460;16338
Syddanmark;2021-08-05;F;81;0;2;2584;320541;16340
Hovedstaden;2021-08-05;M;184;1;3;2585;320725;16343
Midtjylland;2021-08-05;M;102;0;0;2585;320827;16343
Nordjylland;2021-08-05;M;62;0;2;2585;320889;16345
Sjælland;2021-08-05;M;40;0;1;2585;320929;16346
Syddanmark;2021-08-05;M;97;0;3;2585;321026;16349
Hovedstaden;2021-08-06;F;184;0;3;2585;321210;16352
Midtjylland;2021-08-06;F;95;0;1;2585;321305;16353
Nordjylland;2021-08-06;F;46;0;0;2585;321351;16353
Sjælland;2021-08-06;F;47;0;2;2585;321398;16355
Syddanmark;2021-08-06;F;68;0;2;2585;321466;16357
Hovedstaden;2021-08-06;M;187;0;3;2585;321653;16360
Midtjylland;2021-08-06;M;110;0;1;2585;321763;16361
Nordjylland;2021-08-06;M;66;0;2;2585;321829;16363
Sjælland;2021-08-06;M;40;0;1;2585;321869;16364
Syddanmark;2021-08-06;M;71;0;1;2585;321940;16365
Hovedstaden;2021-08-07;F;206;0;6;2585;322146;16371
Midtjylland;2021-08-07;F;98;0;1;2585;322244;16372
Nordjylland;2021-08-07;F;52;0;0;2585;322296;16372
Sjælland;2021-08-07;F;36;0;2;2585;322332;16374
Syddanmark;2021-08-07;F;56;0;2;2585;322388;16376
Hovedstaden;2021-08-07;M;178;0;8;2585;322566;16384
Midtjylland;2021-08-07;M;92;0;3;2585;322658;16387
Nordjylland;2021-08-07;M;38;0;0;2585;322696;16387
Sjælland;2021-08-07;M;24;0;0;2585;322720;16387
Syddanmark;2021-08-07;M;70;0;1;2585;322790;16388
Hovedstaden;2021-08-08;F;198;0;4;2585;322988;16392
Midtjylland;2021-08-08;F;109;0;2;2585;323097;16394
Nordjylland;2021-08-08;F;55;0;0;2585;323152;16394
Sjælland;2021-08-08;F;40;0;3;2585;323192;16397
Syddanmark;2021-08-08;F;77;0;2;2585;323269;16399
Hovedstaden;2021-08-08;M;197;1;6;2586;323466;16405
Midtjylland;2021-08-08;M;122;0;2;2586;323588;16407
Nordjylland;2021-08-08;M;60;0;1;2586;323648;16408
Sjælland;2021-08-08;M;47;0;0;2586;323695;16408
Syddanmark;2021-08-08;M;78;0;5;2586;323773;16413
Hovedstaden;2021-08-09;F;256;0;7;2586;324029;16420
Midtjylland;2021-08-09;F;99;0;4;2586;324128;16424
Nordjylland;2021-08-09;F;74;0;2;2586;324202;16426
Sjælland;2021-08-09;F;53;0;0;2586;324255;16426
Syddanmark;2021-08-09;F;90;0;2;2586;324345;16428
Hovedstaden;2021-08-09;M;217;0;8;2586;324562;16436
Midtjylland;2021-08-09;M;101;1;4;2587;324663;16440
Nordjylland;2021-08-09;M;47;0;3;2587;324710;16443
Sjælland;2021-08-09;M;73;0;2;2587;324783;16445
Syddanmark;2021-08-09;M;87;0;1;2587;324870;16446
Hovedstaden;2021-08-10;F;204;0;4;2587;325074;16450
Midtjylland;2021-08-10;F;128;0;2;2587;325202;16452
Nordjylland;2021-08-10;F;53;0;0;2587;325255;16452
Sjælland;2021-08-10;F;60;1;3;2588;325315;16455
Syddanmark;2021-08-10;F;80;0;3;2588;325395;16458
Hovedstaden;2021-08-10;M;217;2;12;2590;325612;16470
Midtjylland;2021-08-10;M;130;0;1;2590;325742;16471
Nordjylland;2021-08-10;M;62;0;1;2590;325804;16472
Sjælland;2021-08-10;M;49;0;0;2590;325853;16472
Syddanmark;2021-08-10;M;99;0;3;2590;325952;16475
Hovedstaden;2021-08-11;F;210;0;6;2590;326162;16481
Midtjylland;2021-08-11;F;118;0;2;2590;326280;16483
Nordjylland;2021-08-11;F;45;0;0;2590;326325;16483
Sjælland;2021-08-11;F;65;0;5;2590;326390;16488
Syddanmark;2021-08-11;F;68;0;4;2590;326458;16492
Hovedstaden;2021-08-11;M;186;0;6;2590;326644;16498
Midtjylland;2021-08-11;M;117;0;1;2590;326761;16499
Nordjylland;2021-08-11;M;58;1;4;2591;326819;16503
Sjælland;2021-08-11;M;58;0;2;2591;326877;16505
Syddanmark;2021-08-11;M;65;0;2;2591;326942;16507
Hovedstaden;2021-08-12;F;196;1;8;2592;327138;16515
Midtjylland;2021-08-12;F;136;0;5;2592;327274;16520
Nordjylland;2021-08-12;F;57;0;1;2592;327331;16521
Sjælland;2021-08-12;F;52;0;1;2592;327383;16522
Syddanmark;2021-08-12;F;79;0;2;2592;327462;16524
Hovedstaden;2021-08-12;M;185;1;8;2593;327647;16532
Midtjylland;2021-08-12;M;121;0;1;2593;327768;16533
Nordjylland;2021-08-12;M;53;0;0;2593;327821;16533
Sjælland;2021-08-12;M;60;0;1;2593;327881;16534
Syddanmark;2021-08-12;M;63;0;2;2593;327944;16536
Hovedstaden;2021-08-13;F;203;0;4;2593;328147;16540
Midtjylland;2021-08-13;F;111;0;4;2593;328258;16544
Nordjylland;2021-08-13;F;51;0;0;2593;328309;16544
Sjælland;2021-08-13;F;62;0;4;2593;328371;16548
Syddanmark;2021-08-13;F;76;0;0;2593;328447;16548
Hovedstaden;2021-08-13;M;194;1;9;2594;328641;16557
Midtjylland;2021-08-13;M;96;0;5;2594;328737;16562
Nordjylland;2021-08-13;M;53;0;1;2594;328790;16563
Sjælland;2021-08-13;M;62;0;1;2594;328852;16564
Syddanmark;2021-08-13;M;57;0;0;2594;328909;16564
Hovedstaden;2021-08-14;F;153;1;9;2595;329062;16573
Midtjylland;2021-08-14;F;100;0;1;2595;329162;16574
Nordjylland;2021-08-14;F;40;0;1;2595;329202;16575
Sjælland;2021-08-14;F;42;0;1;2595;329244;16576
Syddanmark;2021-08-14;F;84;0;4;2595;329328;16580
Hovedstaden;2021-08-14;M;177;1;5;2596;329505;16585
Midtjylland;2021-08-14;M;100;0;5;2596;329605;16590
Nordjylland;2021-08-14;M;38;0;0;2596;329643;16590
Sjælland;2021-08-14;M;34;0;3;2596;329677;16593
Syddanmark;2021-08-14;M;66;0;4;2596;329743;16597
Hovedstaden;2021-08-15;F;193;0;6;2596;329936;16603
Midtjylland;2021-08-15;F;128;0;6;2596;330064;16609
Nordjylland;2021-08-15;F;34;0;1;2596;330098;16610
Sjælland;2021-08-15;F;44;0;2;2596;330142;16612
Syddanmark;2021-08-15;F;90;0;2;2596;330232;16614
Hovedstaden;2021-08-15;M;202;0;6;2596;330434;16620
Midtjylland;2021-08-15;M;115;0;3;2596;330549;16623
Nordjylland;2021-08-15;M;33;0;1;2596;330582;16624
Sjælland;2021-08-15;M;30;0;0;2596;330612;16624
Syddanmark;2021-08-15;M;74;0;4;2596;330686;16628
Hovedstaden;2021-08-16;F;230;1;7;2597;330916;16635
Midtjylland;2021-08-16;F;133;1;5;2598;331049;16640
Nordjylland;2021-08-16;F;51;0;1;2598;331100;16641
Sjælland;2021-08-16;F;46;0;2;2598;331146;16643
Syddanmark;2021-08-16;F;128;0;2;2598;331274;16645
Hovedstaden;2021-08-16;M;196;0;7;2598;331470;16652
Midtjylland;2021-08-16;M;119;0;1;2598;331589;16653
Nordjylland;2021-08-16;M;52;0;2;2598;331641;16655
Sjælland;2021-08-16;M;54;0;2;2598;331695;16657
Syddanmark;2021-08-16;M;94;0;2;2598;331789;16659
Hovedstaden;2021-08-17;F;186;0;9;2598;331975;16668
Midtjylland;2021-08-17;F;117;0;4;2598;332092;16672
Nordjylland;2021-08-17;F;55;1;3;2599;332147;16675
Sjælland;2021-08-17;F;48;0;1;2599;332195;16676
Syddanmark;2021-08-17;F;105;0;2;2599;332300;16678
Hovedstaden;2021-08-17;M;188;0;6;2599;332488;16684
Midtjylland;2021-08-17;M;130;0;2;2599;332618;16686
Nordjylland;2021-08-17;M;51;0;2;2599;332669;16688
Sjælland;2021-08-17;M;38;0;2;2599;332707;16690
Syddanmark;2021-08-17;M;109;0;0;2599;332816;16690
Hovedstaden;2021-08-18;F;238;0;11;2599;333054;16701
Midtjylland;2021-08-18;F;107;0;1;2599;333161;16702
Nordjylland;2021-08-18;F;38;0;1;2599;333199;16703
Sjælland;2021-08-18;F;42;0;1;2599;333241;16704
Syddanmark;2021-08-18;F;97;0;4;2599;333338;16708
Hovedstaden;2021-08-18;M;187;0;6;2599;333525;16714
Midtjylland;2021-08-18;M;104;0;1;2599;333629;16715
Nordjylland;2021-08-18;M;46;0;3;2599;333675;16718
Sjælland;2021-08-18;M;46;0;1;2599;333721;16719
Syddanmark;2021-08-18;M;75;0;1;2599;333796;16720
Hovedstaden;2021-08-19;F;237;1;10;2600;334033;16730
Midtjylland;2021-08-19;F;117;0;6;2600;334150;16736
Nordjylland;2021-08-19;F;50;0;3;2600;334200;16739
Sjælland;2021-08-19;F;52;0;3;2600;334252;16742
Syddanmark;2021-08-19;F;86;0;0;2600;334338;16742
Hovedstaden;2021-08-19;M;198;0;4;2600;334536;16746
Midtjylland;2021-08-19;M;105;0;1;2600;334641;16747
Nordjylland;2021-08-19;M;45;0;1;2600;334686;16748
Sjælland;2021-08-19;M;40;0;2;2600;334726;16750
Syddanmark;2021-08-19;M;96;0;3;2600;334822;16753
Hovedstaden;2021-08-20;F;272;0;9;2600;335094;16762
Midtjylland;2021-08-20;F;95;1;4;2601;335189;16766
Nordjylland;2021-08-20;F;40;0;1;2601;335229;16767
Sjælland;2021-08-20;F;44;0;3;2601;335273;16770
Syddanmark;2021-08-20;F;81;0;1;2601;335354;16771
Hovedstaden;2021-08-20;M;203;0;6;2601;335557;16777
Midtjylland;2021-08-20;M;102;0;2;2601;335659;16779
Nordjylland;2021-08-20;M;42;0;0;2601;335701;16779
Sjælland;2021-08-20;M;56;0;1;2601;335757;16780
Syddanmark;2021-08-20;M;58;1;3;2602;335815;16783
Hovedstaden;2021-08-21;F;240;1;14;2603;336055;16797
Midtjylland;2021-08-21;F;63;0;0;2603;336118;16797
Nordjylland;2021-08-21;F;23;0;1;2603;336141;16798
Sjælland;2021-08-21;F;30;0;0;2603;336171;16798
Syddanmark;2021-08-21;F;55;1;0;2604;336226;16798
Hovedstaden;2021-08-21;M;206;0;7;2604;336432;16805
Midtjylland;2021-08-21;M;50;0;2;2604;336482;16807
Nordjylland;2021-08-21;M;32;0;0;2604;336514;16807
Sjælland;2021-08-21;M;29;1;2;2605;336543;16809
Syddanmark;2021-08-21;M;45;1;2;2606;336588;16811
Hovedstaden;2021-08-22;F;303;0;7;2606;336891;16818
Midtjylland;2021-08-22;F;92;0;4;2606;336983;16822
Nordjylland;2021-08-22;F;36;0;1;2606;337019;16823
Sjælland;2021-08-22;F;38;0;1;2606;337057;16824
Syddanmark;2021-08-22;F;81;0;1;2606;337138;16825
Hovedstaden;2021-08-22;M;242;0;13;2606;337380;16838
Midtjylland;2021-08-22;M;78;0;2;2606;337458;16840
Nordjylland;2021-08-22;M;26;0;0;2606;337484;16840
Sjælland;2021-08-22;M;35;0;2;2606;337519;16842
Syddanmark;2021-08-22;M;65;0;4;2606;337584;16846
Hovedstaden;2021-08-23;F;258;2;10;2608;337842;16856
Midtjylland;2021-08-23;F;105;0;1;2608;337947;16857
Nordjylland;2021-08-23;F;27;0;0;2608;337974;16857
Sjælland;2021-08-23;F;53;0;4;2608;338027;16861
Syddanmark;2021-08-23;F;90;1;3;2609;338117;16864
Hovedstaden;2021-08-23;M;254;1;5;2610;338371;16869
Midtjylland;2021-08-23;M;101;1;5;2611;338472;16874
Nordjylland;2021-08-23;M;43;0;1;2611;338515;16875
Sjælland;2021-08-23;M;43;0;2;2611;338558;16877
Syddanmark;2021-08-23;M;81;1;2;2612;338639;16879
Hovedstaden;2021-08-24;F;319;0;14;2612;338958;16893
Midtjylland;2021-08-24;F;74;0;3;2612;339032;16896
Nordjylland;2021-08-24;F;34;0;3;2612;339066;16899
Sjælland;2021-08-24;F;43;0;1;2612;339109;16900
Syddanmark;2021-08-24;F;79;0;3;2612;339188;16903
Hovedstaden;2021-08-24;M;240;0;5;2612;339428;16908
Midtjylland;2021-08-24;M;78;0;4;2612;339506;16912
Nordjylland;2021-08-24;M;28;0;1;2612;339534;16913
Sjælland;2021-08-24;M;37;0;3;2612;339571;16916
Syddanmark;2021-08-24;M;83;0;3;2612;339654;16919
Hovedstaden;2021-08-25;F;306;0;11;2612;339960;16930
Midtjylland;2021-08-25;F;74;0;0;2612;340034;16930
Nordjylland;2021-08-25;F;25;0;1;2612;340059;16931
Sjælland;2021-08-25;F;48;0;1;2612;340107;16932
Syddanmark;2021-08-25;F;79;0;2;2612;340186;16934
Hovedstaden;2021-08-25;M;205;1;10;2613;340391;16944
Midtjylland;2021-08-25;M;75;0;1;2613;340466;16945
Nordjylland;2021-08-25;M;25;0;1;2613;340491;16946
Sjælland;2021-08-25;M;51;0;4;2613;340542;16950
Syddanmark;2021-08-25;M;72;0;2;2613;340614;16952
Hovedstaden;2021-08-26;F;254;0;6;2613;340868;16958
Midtjylland;2021-08-26;F;113;0;2;2613;340981;16960
Nordjylland;2021-08-26;F;40;0;0;2613;341021;16960
Sjælland;2021-08-26;F;39;0;2;2613;341060;16962
Syddanmark;2021-08-26;F;87;1;2;2614;341147;16964
Hovedstaden;2021-08-26;M;246;1;4;2615;341393;16968
Midtjylland;2021-08-26;M;88;0;0;2615;341481;16968
Nordjylland;2021-08-26;M;35;0;0;2615;341516;16968
Sjælland;2021-08-26;M;41;0;2;2615;341557;16970
Syddanmark;2021-08-26;M;92;0;1;2615;341649;16971
Hovedstaden;2021-08-27;F;200;0;9;2615;341849;16980
Midtjylland;2021-08-27;F;77;2;3;2617;341926;16983
Nordjylland;2021-08-27;F;14;1;1;2618;341940;16984
Sjælland;2021-08-27;F;36;0;0;2618;341976;16984
Syddanmark;2021-08-27;F;66;1;3;2619;342042;16987
Hovedstaden;2021-08-27;M;161;2;6;2621;342203;16993
Midtjylland;2021-08-27;M;66;1;4;2622;342269;16997
Nordjylland;2021-08-27;M;29;1;1;2623;342298;16998
Sjælland;2021-08-27;M;40;2;3;2625;342338;17001
Syddanmark;2021-08-27;M;55;0;3;2625;342393;17004
Hovedstaden;2021-08-28;F;201;2;3;2627;342594;17007
Midtjylland;2021-08-28;F;58;0;1;2627;342652;17008
Nordjylland;2021-08-28;F;13;0;1;2627;342665;17009
Sjælland;2021-08-28;F;39;0;2;2627;342704;17011
Syddanmark;2021-08-28;F;48;0;2;2627;342752;17013
Hovedstaden;2021-08-28;M;176;1;3;2628;342928;17016
Midtjylland;2021-08-28;M;60;0;5;2628;342988;17021
Nordjylland;2021-08-28;M;19;0;0;2628;343007;17021
Sjælland;2021-08-28;M;23;0;0;2628;343030;17021
Syddanmark;2021-08-28;M;38;0;3;2628;343068;17024
Hovedstaden;2021-08-29;F;209;0;10;2628;343277;17034
Midtjylland;2021-08-29;F;61;0;4;2628;343338;17038
Nordjylland;2021-08-29;F;24;1;1;2629;343362;17039
Sjælland;2021-08-29;F;36;0;2;2629;343398;17041
Syddanmark;2021-08-29;F;58;0;1;2629;343456;17042
Hovedstaden;2021-08-29;M;223;1;8;2630;343679;17050
Midtjylland;2021-08-29;M;64;0;1;2630;343743;17051
Nordjylland;2021-08-29;M;14;0;0;2630;343757;17051
Sjælland;2021-08-29;M;38;0;1;2630;343795;17052
Syddanmark;2021-08-29;M;54;0;2;2630;343849;17054
Hovedstaden;2021-08-30;F;245;0;9;2630;344094;17063
Midtjylland;2021-08-30;F;80;0;4;2630;344174;17067
Nordjylland;2021-08-30;F;30;1;1;2631;344204;17068
Sjælland;2021-08-30;F;46;0;1;2631;344250;17069
Syddanmark;2021-08-30;F;91;1;2;2632;344341;17071
Hovedstaden;2021-08-30;M;201;2;11;2634;344542;17082
Midtjylland;2021-08-30;M;68;0;2;2634;344610;17084
Nordjylland;2021-08-30;M;31;0;2;2634;344641;17086
Sjælland;2021-08-30;M;52;0;1;2634;344693;17087
Syddanmark;2021-08-30;M;66;0;1;2634;344759;17088
Hovedstaden;2021-08-31;F;218;1;5;2635;344977;17093
Midtjylland;2021-08-31;F;82;0;2;2635;345059;17095
Nordjylland;2021-08-31;F;32;0;1;2635;345091;17096
Sjælland;2021-08-31;F;35;1;1;2636;345126;17097
Syddanmark;2021-08-31;F;66;0;1;2636;345192;17098
Hovedstaden;2021-08-31;M;194;0;6;2636;345386;17104
Midtjylland;2021-08-31;M;73;0;0;2636;345459;17104
Nordjylland;2021-08-31;M;19;0;0;2636;345478;17104
Sjælland;2021-08-31;M;34;0;1;2636;345512;17105
Syddanmark;2021-08-31;M;67;0;0;2636;345579;17105
Hovedstaden;2021-09-01;F;215;0;7;2636;345794;17112
Midtjylland;2021-09-01;F;66;0;0;2636;345860;17112
Nordjylland;2021-09-01;F;22;0;4;2636;345882;17116
Sjælland;2021-09-01;F;43;0;0;2636;345925;17116
Syddanmark;2021-09-01;F;41;0;1;2636;345966;17117
Hovedstaden;2021-09-01;M;185;2;8;2638;346151;17125
Midtjylland;2021-09-01;M;49;0;1;2638;346200;17126
Nordjylland;2021-09-01;M;16;1;2;2639;346216;17128
Sjælland;2021-09-01;M;39;0;3;2639;346255;17131
Syddanmark;2021-09-01;M;40;0;1;2639;346295;17132
Hovedstaden;2021-09-02;F;160;0;7;2639;346455;17139
Midtjylland;2021-09-02;F;46;0;0;2639;346501;17139
Nordjylland;2021-09-02;F;19;0;4;2639;346520;17143
Sjælland;2021-09-02;F;39;1;1;2640;346559;17144
Syddanmark;2021-09-02;F;40;0;1;2640;346599;17145
Hovedstaden;2021-09-02;M;156;0;6;2640;346755;17151
Midtjylland;2021-09-02;M;37;0;2;2640;346792;17153
Nordjylland;2021-09-02;M;17;0;2;2640;346809;17155
Sjælland;2021-09-02;M;40;0;1;2640;346849;17156
Syddanmark;2021-09-02;M;35;0;0;2640;346884;17156
Hovedstaden;2021-09-03;F;134;0;5;2640;347018;17161
Midtjylland;2021-09-03;F;61;0;4;2640;347079;17165
Nordjylland;2021-09-03;F;13;0;1;2640;347092;17166
Sjælland;2021-09-03;F;24;0;1;2640;347116;17167
Syddanmark;2021-09-03;F;47;0;2;2640;347163;17169
Hovedstaden;2021-09-03;M;146;0;3;2640;347309;17172
Midtjylland;2021-09-03;M;46;1;2;2641;347355;17174
Nordjylland;2021-09-03;M;12;0;2;2641;347367;17176
Sjælland;2021-09-03;M;32;0;1;2641;347399;17177
Syddanmark;2021-09-03;M;25;0;0;2641;347424;17177
Hovedstaden;2021-09-04;F;124;1;3;2642;347548;17180
Midtjylland;2021-09-04;F;37;0;0;2642;347585;17180
Nordjylland;2021-09-04;F;9;0;1;2642;347594;17181
Sjælland;2021-09-04;F;15;0;1;2642;347609;17182
Syddanmark;2021-09-04;F;39;0;1;2642;347648;17183
Hovedstaden;2021-09-04;M;115;1;2;2643;347763;17185
Midtjylland;2021-09-04;M;37;3;5;2646;347800;17190
Nordjylland;2021-09-04;M;7;0;0;2646;347807;17190
Sjælland;2021-09-04;M;16;0;2;2646;347823;17192
Syddanmark;2021-09-04;M;23;1;1;2647;347846;17193
Hovedstaden;2021-09-05;F;148;1;6;2648;347994;17199
Midtjylland;2021-09-05;F;40;0;1;2648;348034;17200
Nordjylland;2021-09-05;F;11;0;2;2648;348045;17202
Sjælland;2021-09-05;F;23;0;1;2648;348068;17203
Syddanmark;2021-09-05;F;27;0;1;2648;348095;17204
Hovedstaden;2021-09-05;M;136;0;5;2648;348231;17209
Midtjylland;2021-09-05;M;32;0;3;2648;348263;17212
Nordjylland;2021-09-05;M;9;0;0;2648;348272;17212
Sjælland;2021-09-05;M;26;0;1;2648;348298;17213
Syddanmark;2021-09-05;M;27;0;0;2648;348325;17213
Hovedstaden;2021-09-06;F;164;1;8;2649;348489;17221
Midtjylland;2021-09-06;F;35;0;1;2649;348524;17222
Nordjylland;2021-09-06;F;16;0;0;2649;348540;17222
Sjælland;2021-09-06;F;58;0;1;2649;348598;17223
Syddanmark;2021-09-06;F;45;1;1;2650;348643;17224
Hovedstaden;2021-09-06;M;157;0;5;2650;348800;17229
Midtjylland;2021-09-06;M;32;0;0;2650;348832;17229
Nordjylland;2021-09-06;M;9;0;0;2650;348841;17229
Sjælland;2021-09-06;M;45;0;0;2650;348886;17229
Syddanmark;2021-09-06;M;31;0;0;2650;348917;17229
Hovedstaden;2021-09-07;F;177;3;12;2653;349094;17241
Midtjylland;2021-09-07;F;49;2;3;2655;349143;17244
Nordjylland;2021-09-07;F;11;0;1;2655;349154;17245
Sjælland;2021-09-07;F;47;0;3;2655;349201;17248
Syddanmark;2021-09-07;F;47;0;0;2655;349248;17248
Hovedstaden;2021-09-07;M;144;0;2;2655;349392;17250
Midtjylland;2021-09-07;M;50;1;2;2656;349442;17252
Nordjylland;2021-09-07;M;5;0;0;2656;349447;17252
Sjælland;2021-09-07;M;46;0;1;2656;349493;17253
Syddanmark;2021-09-07;M;36;0;1;2656;349529;17254
Hovedstaden;2021-09-08;F;137;0;3;2656;349666;17257
Midtjylland;2021-09-08;F;43;2;4;2658;349709;17261
Nordjylland;2021-09-08;F;13;0;0;2658;349722;17261
Sjælland;2021-09-08;F;32;0;0;2658;349754;17261
Syddanmark;2021-09-08;F;28;0;0;2658;349782;17261
Hovedstaden;2021-09-08;M;137;0;5;2658;349919;17266
Midtjylland;2021-09-08;M;32;0;1;2658;349951;17267
Nordjylland;2021-09-08;M;15;0;0;2658;349966;17267
Sjælland;2021-09-08;M;33;1;4;2659;349999;17271
Syddanmark;2021-09-08;M;32;0;1;2659;350031;17272
Hovedstaden;2021-09-09;F;120;0;2;2659;350151;17274
Midtjylland;2021-09-09;F;54;0;0;2659;350205;17274
Nordjylland;2021-09-09;F;17;0;0;2659;350222;17274
Sjælland;2021-09-09;F;41;0;3;2659;350263;17277
Syddanmark;2021-09-09;F;36;0;2;2659;350299;17279
Hovedstaden;2021-09-09;M;99;0;3;2659;350398;17282
Midtjylland;2021-09-09;M;37;0;2;2659;350435;17284
Nordjylland;2021-09-09;M;11;0;1;2659;350446;17285
Sjælland;2021-09-09;M;48;1;3;2660;350494;17288
Syddanmark;2021-09-09;M;33;0;0;2660;350527;17288
Hovedstaden;2021-09-10;F;86;0;1;2660;350613;17289
Midtjylland;2021-09-10;F;35;0;2;2660;350648;17291
Nordjylland;2021-09-10;F;8;0;0;2660;350656;17291
Sjælland;2021-09-10;F;34;0;2;2660;350690;17293
Syddanmark;2021-09-10;F;34;1;1;2661;350724;17294
Hovedstaden;2021-09-10;M;90;2;4;2663;350814;17298
Midtjylland;2021-09-10;M;33;0;2;2663;350847;17300
Nordjylland;2021-09-10;M;9;0;0;2663;350856;17300
Sjælland;2021-09-10;M;29;1;1;2664;350885;17301
Syddanmark;2021-09-10;M;24;0;2;2664;350909;17303
Hovedstaden;2021-09-11;F;95;1;3;2665;351004;17306
Midtjylland;2021-09-11;F;28;0;1;2665;351032;17307
Nordjylland;2021-09-11;F;7;0;0;2665;351039;17307
Sjælland;2021-09-11;F;24;0;0;2665;351063;17307
Syddanmark;2021-09-11;F;14;0;0;2665;351077;17307
Hovedstaden;2021-09-11;M;79;0;4;2665;351156;17311
Midtjylland;2021-09-11;M;27;0;2;2665;351183;17313
Nordjylland;2021-09-11;M;3;0;0;2665;351186;17313
Sjælland;2021-09-11;M;18;0;2;2665;351204;17315
Syddanmark;2021-09-11;M;19;0;0;2665;351223;17315
Hovedstaden;2021-09-12;F;91;1;2;2666;351314;17317
Midtjylland;2021-09-12;F;23;0;0;2666;351337;17317
Nordjylland;2021-09-12;F;9;0;0;2666;351346;17317
Sjælland;2021-09-12;F;21;0;0;2666;351367;17317
Syddanmark;2021-09-12;F;13;0;0;2666;351380;17317
Hovedstaden;2021-09-12;M;103;0;1;2666;351483;17318
Midtjylland;2021-09-12;M;20;1;2;2667;351503;17320
Nordjylland;2021-09-12;M;10;0;1;2667;351513;17321
Sjælland;2021-09-12;M;29;0;1;2667;351542;17322
Syddanmark;2021-09-12;M;14;0;1;2667;351556;17323
Hovedstaden;2021-09-13;F;93;0;5;2667;351649;17328
Midtjylland;2021-09-13;F;29;0;1;2667;351678;17329
Nordjylland;2021-09-13;F;17;0;1;2667;351695;17330
Sjælland;2021-09-13;F;36;0;2;2667;351731;17332
Syddanmark;2021-09-13;F;23;0;0;2667;351754;17332
Hovedstaden;2021-09-13;M;105;1;1;2668;351859;17333
Midtjylland;2021-09-13;M;33;0;1;2668;351892;17334
Nordjylland;2021-09-13;M;21;0;3;2668;351913;17337
Sjælland;2021-09-13;M;30;0;2;2668;351943;17339
Syddanmark;2021-09-13;M;26;0;1;2668;351969;17340
Hovedstaden;2021-09-14;F;83;1;0;2669;352052;17340
Midtjylland;2021-09-14;F;21;1;1;2670;352073;17341
Nordjylland;2021-09-14;F;14;0;0;2670;352087;17341
Sjælland;2021-09-14;F;28;0;2;2670;352115;17343
Syddanmark;2021-09-14;F;20;0;0;2670;352135;17343
Hovedstaden;2021-09-14;M;101;0;1;2670;352236;17344
Midtjylland;2021-09-14;M;26;0;0;2670;352262;17344
Nordjylland;2021-09-14;M;9;0;0;2670;352271;17344
Sjælland;2021-09-14;M;15;0;0;2670;352286;17344
Syddanmark;2021-09-14;M;30;0;0;2670;352316;17344
Hovedstaden;2021-09-15;F;86;0;4;2670;352402;17348
Midtjylland;2021-09-15;F;30;0;0;2670;352432;17348
Nordjylland;2021-09-15;F;17;0;1;2670;352449;17349
Sjælland;2021-09-15;F;21;0;1;2670;352470;17350
Syddanmark;2021-09-15;F;22;0;0;2670;352492;17350
Hovedstaden;2021-09-15;M;68;0;2;2670;352560;17352
Midtjylland;2021-09-15;M;25;0;0;2670;352585;17352
Nordjylland;2021-09-15;M;10;0;1;2670;352595;17353
Sjælland;2021-09-15;M;20;0;0;2670;352615;17353
Syddanmark;2021-09-15;M;18;1;3;2671;352633;17356
Hovedstaden;2021-09-16;F;72;0;3;2671;352705;17359
Midtjylland;2021-09-16;F;25;0;1;2671;352730;17360
Nordjylland;2021-09-16;F;13;0;0;2671;352743;17360
Sjælland;2021-09-16;F;18;0;1;2671;352761;17361
Syddanmark;2021-09-16;F;29;0;0;2671;352790;17361
Hovedstaden;2021-09-16;M;72;0;2;2671;352862;17363
Midtjylland;2021-09-16;M;20;0;2;2671;352882;17365
Nordjylland;2021-09-16;M;10;0;0;2671;352892;17365
Sjælland;2021-09-16;M;18;0;2;2671;352910;17367
Syddanmark;2021-09-16;M;31;0;0;2671;352941;17367
Hovedstaden;2021-09-17;F;64;0;4;2671;353005;17371
Midtjylland;2021-09-17;F;22;0;0;2671;353027;17371
Nordjylland;2021-09-17;F;7;1;1;2672;353034;17372
Sjælland;2021-09-17;F;15;0;2;2672;353049;17374
Syddanmark;2021-09-17;F;40;1;0;2673;353089;17374
Hovedstaden;2021-09-17;M;83;0;2;2673;353172;17376
Midtjylland;2021-09-17;M;24;0;0;2673;353196;17376
Nordjylland;2021-09-17;M;9;0;0;2673;353205;17376
Sjælland;2021-09-17;M;21;0;0;2673;353226;17376
Syddanmark;2021-09-17;M;27;0;1;2673;353253;17377
Hovedstaden;2021-09-18;F;50;0;1;2673;353303;17378
Midtjylland;2021-09-18;F;30;0;0;2673;353333;17378
Nordjylland;2021-09-18;F;7;0;1;2673;353340;17379
Sjælland;2021-09-18;F;18;1;2;2674;353358;17381
Syddanmark;2021-09-18;F;16;0;3;2674;353374;17384
Hovedstaden;2021-09-18;M;41;1;1;2675;353415;17385
Midtjylland;2021-09-18;M;14;0;0;2675;353429;17385
Nordjylland;2021-09-18;M;3;0;1;2675;353432;17386
Sjælland;2021-09-18;M;15;1;1;2676;353447;17387
Syddanmark;2021-09-18;M;15;0;0;2676;353462;17387
Hovedstaden;2021-09-19;F;67;0;4;2676;353529;17391
Midtjylland;2021-09-19;F;31;1;1;2677;353560;17392
Nordjylland;2021-09-19;F;8;0;0;2677;353568;17392
Sjælland;2021-09-19;F;11;0;1;2677;353579;17393
Syddanmark;2021-09-19;F;25;0;2;2677;353604;17395
Hovedstaden;2021-09-19;M;57;0;3;2677;353661;17398
Midtjylland;2021-09-19;M;22;0;0;2677;353683;17398
Nordjylland;2021-09-19;M;9;0;0;2677;353692;17398
Sjælland;2021-09-19;M;12;0;0;2677;353704;17398
Syddanmark;2021-09-19;M;29;0;1;2677;353733;17399
Hovedstaden;2021-09-20;F;69;0;1;2677;353802;17400
Midtjylland;2021-09-20;F;31;0;2;2677;353833;17402
Nordjylland;2021-09-20;F;12;0;0;2677;353845;17402
Sjælland;2021-09-20;F;40;0;1;2677;353885;17403
Syddanmark;2021-09-20;F;37;0;1;2677;353922;17404
Hovedstaden;2021-09-20;M;75;0;4;2677;353997;17408
Midtjylland;2021-09-20;M;30;0;1;2677;354027;17409
Nordjylland;2021-09-20;M;18;0;2;2677;354045;17411
Sjælland;2021-09-20;M;33;0;1;2677;354078;17412
Syddanmark;2021-09-20;M;35;1;2;2678;354113;17414
Hovedstaden;2021-09-21;F;80;1;3;2679;354193;17417
Midtjylland;2021-09-21;F;27;0;0;2679;354220;17417
Nordjylland;2021-09-21;F;13;0;0;2679;354233;17417
Sjælland;2021-09-21;F;30;0;1;2679;354263;17418
Syddanmark;2021-09-21;F;37;0;3;2679;354300;17421
Hovedstaden;2021-09-21;M;44;0;0;2679;354344;17421
Midtjylland;2021-09-21;M;35;0;3;2679;354379;17424
Nordjylland;2021-09-21;M;16;0;2;2679;354395;17426
Sjælland;2021-09-21;M;28;0;0;2679;354423;17426
Syddanmark;2021-09-21;M;31;0;1;2679;354454;17427
Hovedstaden;2021-09-22;F;77;1;2;2680;354531;17429
Midtjylland;2021-09-22;F;32;0;1;2680;354563;17430
Nordjylland;2021-09-22;F;30;0;1;2680;354593;17431
Sjælland;2021-09-22;F;27;0;1;2680;354620;17432
Syddanmark;2021-09-22;F;30;4;0;2684;354650;17432
Hovedstaden;2021-09-22;M;62;0;3;2684;354712;17435
Midtjylland;2021-09-22;M;32;0;0;2684;354744;17435
Nordjylland;2021-09-22;M;24;0;1;2684;354768;17436
Sjælland;2021-09-22;M;23;1;3;2685;354791;17439
Syddanmark;2021-09-22;M;20;0;1;2685;354811;17440
Hovedstaden;2021-09-23;F;68;0;1;2685;354879;17441
Midtjylland;2021-09-23;F;31;0;0;2685;354910;17441
Nordjylland;2021-09-23;F;30;0;0;2685;354940;17441
Sjælland;2021-09-23;F;29;0;0;2685;354969;17441
Syddanmark;2021-09-23;F;28;0;2;2685;354997;17443
Hovedstaden;2021-09-23;M;76;0;5;2685;355073;17448
Midtjylland;2021-09-23;M;27;0;0;2685;355100;17448
Nordjylland;2021-09-23;M;29;0;1;2685;355129;17449
Sjælland;2021-09-23;M;25;0;2;2685;355154;17451
Syddanmark;2021-09-23;M;27;0;2;2685;355181;17453
Hovedstaden;2021-09-24;F;81;0;3;2685;355262;17456
Midtjylland;2021-09-24;F;18;0;2;2685;355280;17458
Nordjylland;2021-09-24;F;25;0;0;2685;355305;17458
Sjælland;2021-09-24;F;33;0;3;2685;355338;17461
Syddanmark;2021-09-24;F;33;0;1;2685;355371;17462
Hovedstaden;2021-09-24;M;62;0;3;2685;355433;17465
Midtjylland;2021-09-24;M;26;1;0;2686;355459;17465
Nordjylland;2021-09-24;M;17;0;1;2686;355476;17466
Sjælland;2021-09-24;M;25;0;3;2686;355501;17469
Syddanmark;2021-09-24;M;31;0;0;2686;355532;17469
Hovedstaden;2021-09-25;F;93;0;2;2686;355625;17471
Midtjylland;2021-09-25;F;16;0;1;2686;355641;17472
Nordjylland;2021-09-25;F;16;1;1;2687;355657;17473
Sjælland;2021-09-25;F;33;0;1;2687;355690;17474
Syddanmark;2021-09-25;F;20;0;0;2687;355710;17474
Hovedstaden;2021-09-25;M;82;0;6;2687;355792;17480
Midtjylland;2021-09-25;M;14;0;0;2687;355806;17480
Nordjylland;2021-09-25;M;12;0;1;2687;355818;17481
Sjælland;2021-09-25;M;25;0;1;2687;355843;17482
Syddanmark;2021-09-25;M;26;1;2;2688;355869;17484
Hovedstaden;2021-09-26;F;82;0;2;2688;355951;17486
Midtjylland;2021-09-26;F;12;0;1;2688;355963;17487
Nordjylland;2021-09-26;F;27;0;0;2688;355990;17487
Sjælland;2021-09-26;F;27;2;2;2690;356017;17489
Syddanmark;2021-09-26;F;32;1;3;2691;356049;17492
Hovedstaden;2021-09-26;M;91;0;6;2691;356140;17498
Midtjylland;2021-09-26;M;17;0;0;2691;356157;17498
Nordjylland;2021-09-26;M;20;1;0;2692;356177;17498
Sjælland;2021-09-26;M;23;0;2;2692;356200;17500
Syddanmark;2021-09-26;M;28;0;1;2692;356228;17501
Hovedstaden;2021-09-27;F;121;0;3;2692;356349;17504
Midtjylland;2021-09-27;F;24;0;0;2692;356373;17504
Nordjylland;2021-09-27;F;25;0;1;2692;356398;17505
Sjælland;2021-09-27;F;60;0;1;2692;356458;17506
Syddanmark;2021-09-27;F;36;0;0;2692;356494;17506
Hovedstaden;2021-09-27;M;119;0;2;2692;356613;17508
Midtjylland;2021-09-27;M;25;1;1;2693;356638;17509
Nordjylland;2021-09-27;M;20;0;1;2693;356658;17510
Sjælland;2021-09-27;M;30;0;1;2693;356688;17511
Syddanmark;2021-09-27;M;32;0;1;2693;356720;17512
Hovedstaden;2021-09-28;F;153;0;2;2693;356873;17514
Midtjylland;2021-09-28;F;44;0;1;2693;356917;17515
Nordjylland;2021-09-28;F;19;1;1;2694;356936;17516
Sjælland;2021-09-28;F;37;0;3;2694;356973;17519
Syddanmark;2021-09-28;F;37;0;0;2694;357010;17519
Hovedstaden;2021-09-28;M;122;0;6;2694;357132;17525
Midtjylland;2021-09-28;M;30;0;1;2694;357162;17526
Nordjylland;2021-09-28;M;21;0;0;2694;357183;17526
Sjælland;2021-09-28;M;18;0;1;2694;357201;17527
Syddanmark;2021-09-28;M;49;1;3;2695;357250;17530
Hovedstaden;2021-09-29;F;115;0;4;2695;357365;17534
Midtjylland;2021-09-29;F;22;0;1;2695;357387;17535
Nordjylland;2021-09-29;F;16;0;0;2695;357403;17535
Sjælland;2021-09-29;F;27;0;1;2695;357430;17536
Syddanmark;2021-09-29;F;25;0;0;2695;357455;17536
Hovedstaden;2021-09-29;M;118;0;4;2695;357573;17540
Midtjylland;2021-09-29;M;29;0;1;2695;357602;17541
Nordjylland;2021-09-29;M;10;0;1;2695;357612;17542
Sjælland;2021-09-29;M;17;0;0;2695;357629;17542
Syddanmark;2021-09-29;M;32;0;0;2695;357661;17542
Hovedstaden;2021-09-30;F;116;0;1;2695;357777;17543
Midtjylland;2021-09-30;F;30;0;0;2695;357807;17543
Nordjylland;2021-09-30;F;17;0;1;2695;357824;17544
Sjælland;2021-09-30;F;33;0;2;2695;357857;17546
Syddanmark;2021-09-30;F;34;0;2;2695;357891;17548
Hovedstaden;2021-09-30;M;105;0;6;2695;357996;17554
Midtjylland;2021-09-30;M;14;0;1;2695;358010;17555
Nordjylland;2021-09-30;M;14;0;0;2695;358024;17555
Sjælland;2021-09-30;M;30;0;2;2695;358054;17557
Syddanmark;2021-09-30;M;53;1;3;2696;358107;17560
Hovedstaden;2021-10-01;F;111;0;4;2696;358218;17564
Midtjylland;2021-10-01;F;20;0;0;2696;358238;17564
Nordjylland;2021-10-01;F;8;0;0;2696;358246;17564
Sjælland;2021-10-01;F;32;0;1;2696;358278;17565
Syddanmark;2021-10-01;F;26;0;2;2696;358304;17567
Hovedstaden;2021-10-01;M;114;0;5;2696;358418;17572
Midtjylland;2021-10-01;M;17;0;2;2696;358435;17574
Nordjylland;2021-10-01;M;7;0;0;2696;358442;17574
Sjælland;2021-10-01;M;34;0;0;2696;358476;17574
Syddanmark;2021-10-01;M;32;0;0;2696;358508;17574
Hovedstaden;2021-10-02;F;89;0;1;2696;358597;17575
Midtjylland;2021-10-02;F;31;0;0;2696;358628;17575
Nordjylland;2021-10-02;F;10;0;0;2696;358638;17575
Sjælland;2021-10-02;F;32;0;0;2696;358670;17575
Syddanmark;2021-10-02;F;19;0;1;2696;358689;17576
Hovedstaden;2021-10-02;M;77;0;4;2696;358766;17580
Midtjylland;2021-10-02;M;15;0;0;2696;358781;17580
Nordjylland;2021-10-02;M;11;0;0;2696;358792;17580
Sjælland;2021-10-02;M;19;0;0;2696;358811;17580
Syddanmark;2021-10-02;M;22;0;1;2696;358833;17581
Hovedstaden;2021-10-03;F;115;0;4;2696;358948;17585
Midtjylland;2021-10-03;F;27;0;0;2696;358975;17585
Nordjylland;2021-10-03;F;10;0;0;2696;358985;17585
Sjælland;2021-10-03;F;16;0;0;2696;359001;17585
Syddanmark;2021-10-03;F;22;0;0;2696;359023;17585
Hovedstaden;2021-10-03;M;126;0;3;2696;359149;17588
Midtjylland;2021-10-03;M;33;0;2;2696;359182;17590
Nordjylland;2021-10-03;M;9;0;0;2696;359191;17590
Sjælland;2021-10-03;M;29;0;2;2696;359220;17592
Syddanmark;2021-10-03;M;22;0;0;2696;359242;17592
Hovedstaden;2021-10-04;F;147;0;5;2696;359389;17597
Midtjylland;2021-10-04;F;27;0;0;2696;359416;17597
Nordjylland;2021-10-04;F;19;0;1;2696;359435;17598
Sjælland;2021-10-04;F;49;0;3;2696;359484;17601
Syddanmark;2021-10-04;F;53;0;2;2696;359537;17603
Hovedstaden;2021-10-04;M;111;1;5;2697;359648;17608
Midtjylland;2021-10-04;M;42;0;1;2697;359690;17609
Nordjylland;2021-10-04;M;15;0;0;2697;359705;17609
Sjælland;2021-10-04;M;40;0;1;2697;359745;17610
Syddanmark;2021-10-04;M;49;0;0;2697;359794;17610
Hovedstaden;2021-10-05;F;147;0;7;2697;359941;17617
Midtjylland;2021-10-05;F;30;0;0;2697;359971;17617
Nordjylland;2021-10-05;F;13;0;0;2697;359984;17617
Sjælland;2021-10-05;F;45;0;2;2697;360029;17619
Syddanmark;2021-10-05;F;46;0;3;2697;360075;17622
Hovedstaden;2021-10-05;M;141;1;4;2698;360216;17626
Midtjylland;2021-10-05;M;43;0;0;2698;360259;17626
Nordjylland;2021-10-05;M;13;0;0;2698;360272;17626
Sjælland;2021-10-05;M;35;1;3;2699;360307;17629
Syddanmark;2021-10-05;M;53;0;0;2699;360360;17629
Hovedstaden;2021-10-06;F;180;0;9;2699;360540;17638
Midtjylland;2021-10-06;F;40;0;0;2699;360580;17638
Nordjylland;2021-10-06;F;22;0;1;2699;360602;17639
Sjælland;2021-10-06;F;28;0;0;2699;360630;17639
Syddanmark;2021-10-06;F;53;0;0;2699;360683;17639
Hovedstaden;2021-10-06;M;173;0;8;2699;360856;17647
Midtjylland;2021-10-06;M;53;0;0;2699;360909;17647
Nordjylland;2021-10-06;M;13;0;0;2699;360922;17647
Sjælland;2021-10-06;M;29;0;4;2699;360951;17651
Syddanmark;2021-10-06;M;46;0;0;2699;360997;17651
Hovedstaden;2021-10-07;F;169;2;5;2701;361166;17656
Midtjylland;2021-10-07;F;48;0;3;2701;361214;17659
Nordjylland;2021-10-07;F;26;0;0;2701;361240;17659
Sjælland;2021-10-07;F;47;0;2;2701;361287;17661
Syddanmark;2021-10-07;F;53;0;1;2701;361340;17662
Hovedstaden;2021-10-07;M;152;0;2;2701;361492;17664
Midtjylland;2021-10-07;M;37;1;0;2702;361529;17664
Nordjylland;2021-10-07;M;24;0;1;2702;361553;17665
Sjælland;2021-10-07;M;45;2;1;2704;361598;17666
Syddanmark;2021-10-07;M;55;0;0;2704;361653;17666
Hovedstaden;2021-10-08;F;166;0;9;2704;361819;17675
Midtjylland;2021-10-08;F;46;1;1;2705;361865;17676
Nordjylland;2021-10-08;F;16;0;0;2705;361881;17676
Sjælland;2021-10-08;F;45;0;2;2705;361926;17678
Syddanmark;2021-10-08;F;36;0;0;2705;361962;17678
Hovedstaden;2021-10-08;M;134;0;3;2705;362096;17681
Midtjylland;2021-10-08;M;52;1;4;2706;362148;17685
Nordjylland;2021-10-08;M;19;0;0;2706;362167;17685
Sjælland;2021-10-08;M;53;0;1;2706;362220;17686
Syddanmark;2021-10-08;M;40;0;0;2706;362260;17686
Hovedstaden;2021-10-09;F;134;0;4;2706;362394;17690
Midtjylland;2021-10-09;F;37;0;0;2706;362431;17690
Nordjylland;2021-10-09;F;17;0;2;2706;362448;17692
Sjælland;2021-10-09;F;32;0;0;2706;362480;17692
Syddanmark;2021-10-09;F;32;0;1;2706;362512;17693
Hovedstaden;2021-10-09;M;107;1;6;2707;362619;17699
Midtjylland;2021-10-09;M;42;0;1;2707;362661;17700
Nordjylland;2021-10-09;M;6;0;0;2707;362667;17700
Sjælland;2021-10-09;M;31;0;0;2707;362698;17700
Syddanmark;2021-10-09;M;33;0;1;2707;362731;17701
Hovedstaden;2021-10-10;F;162;0;3;2707;362893;17704
Midtjylland;2021-10-10;F;48;0;1;2707;362941;17705
Nordjylland;2021-10-10;F;16;0;0;2707;362957;17705
Sjælland;2021-10-10;F;30;0;1;2707;362987;17706
Syddanmark;2021-10-10;F;36;1;0;2708;363023;17706
Hovedstaden;2021-10-10;M;158;0;6;2708;363181;17712
Midtjylland;2021-10-10;M;27;0;2;2708;363208;17714
Nordjylland;2021-10-10;M;5;0;0;2708;363213;17714
Sjælland;2021-10-10;M;27;0;1;2708;363240;17715
Syddanmark;2021-10-10;M;49;0;1;2708;363289;17716
Hovedstaden;2021-10-11;F;192;0;4;2708;363481;17720
Midtjylland;2021-10-11;F;59;0;0;2708;363540;17720
Nordjylland;2021-10-11;F;29;0;0;2708;363569;17720
Sjælland;2021-10-11;F;79;0;2;2708;363648;17722
Syddanmark;2021-10-11;F;64;0;3;2708;363712;17725
Hovedstaden;2021-10-11;M;172;0;5;2708;363884;17730
Midtjylland;2021-10-11;M;49;0;1;2708;363933;17731
Nordjylland;2021-10-11;M;8;0;0;2708;363941;17731
Sjælland;2021-10-11;M;46;0;3;2708;363987;17734
Syddanmark;2021-10-11;M;62;0;1;2708;364049;17735
Hovedstaden;2021-10-12;F;230;1;6;2709;364279;17741
Midtjylland;2021-10-12;F;42;0;0;2709;364321;17741
Nordjylland;2021-10-12;F;26;0;0;2709;364347;17741
Sjælland;2021-10-12;F;59;0;1;2709;364406;17742
Syddanmark;2021-10-12;F;52;0;1;2709;364458;17743
Hovedstaden;2021-10-12;M;184;1;6;2710;364642;17749
Midtjylland;2021-10-12;M;36;1;1;2711;364678;17750
Nordjylland;2021-10-12;M;12;0;0;2711;364690;17750
Sjælland;2021-10-12;M;66;0;5;2711;364756;17755
Syddanmark;2021-10-12;M;58;0;1;2711;364814;17756
Hovedstaden;2021-10-13;F;220;0;12;2711;365034;17768
Midtjylland;2021-10-13;F;41;0;1;2711;365075;17769
Nordjylland;2021-10-13;F;33;1;4;2712;365108;17773
Sjælland;2021-10-13;F;49;0;3;2712;365157;17776
Syddanmark;2021-10-13;F;55;1;2;2713;365212;17778
Hovedstaden;2021-10-13;M;209;0;9;2713;365421;17787
Midtjylland;2021-10-13;M;49;0;1;2713;365470;17788
Nordjylland;2021-10-13;M;15;0;3;2713;365485;17791
Sjælland;2021-10-13;M;51;0;0;2713;365536;17791
Syddanmark;2021-10-13;M;34;0;1;2713;365570;17792
Hovedstaden;2021-10-14;F;211;1;10;2714;365781;17802
Midtjylland;2021-10-14;F;49;0;2;2714;365830;17804
Nordjylland;2021-10-14;F;34;2;4;2716;365864;17808
Sjælland;2021-10-14;F;67;0;0;2716;365931;17808
Syddanmark;2021-10-14;F;58;1;3;2717;365989;17811
Hovedstaden;2021-10-14;M;178;1;7;2718;366167;17818
Midtjylland;2021-10-14;M;34;0;2;2718;366201;17820
Nordjylland;2021-10-14;M;21;0;1;2718;366222;17821
Sjælland;2021-10-14;M;62;0;3;2718;366284;17824
Syddanmark;2021-10-14;M;62;0;2;2718;366346;17826
Hovedstaden;2021-10-15;F;195;0;10;2718;366541;17836
Midtjylland;2021-10-15;F;44;0;1;2718;366585;17837
Nordjylland;2021-10-15;F;14;0;0;2718;366599;17837
Sjælland;2021-10-15;F;56;0;2;2718;366655;17839
Syddanmark;2021-10-15;F;42;0;1;2718;366697;17840
Hovedstaden;2021-10-15;M;163;0;5;2718;366860;17845
Midtjylland;2021-10-15;M;46;0;1;2718;366906;17846
Nordjylland;2021-10-15;M;14;0;1;2718;366920;17847
Sjælland;2021-10-15;M;45;1;2;2719;366965;17849
Syddanmark;2021-10-15;M;39;0;1;2719;367004;17850
Hovedstaden;2021-10-16;F;179;0;5;2719;367183;17855
Midtjylland;2021-10-16;F;37;0;1;2719;367220;17856
Nordjylland;2021-10-16;F;24;0;0;2719;367244;17856
Sjælland;2021-10-16;F;41;0;1;2719;367285;17857
Syddanmark;2021-10-16;F;38;0;0;2719;367323;17857
Hovedstaden;2021-10-16;M;152;1;10;2720;367475;17867
Midtjylland;2021-10-16;M;30;0;0;2720;367505;17867
Nordjylland;2021-10-16;M;29;2;2;2722;367534;17869
Sjælland;2021-10-16;M;39;0;3;2722;367573;17872
Syddanmark;2021-10-16;M;31;0;0;2722;367604;17872
Hovedstaden;2021-10-17;F;222;0;4;2722;367826;17876
Midtjylland;2021-10-17;F;37;0;0;2722;367863;17876
Nordjylland;2021-10-17;F;35;0;0;2722;367898;17876
Sjælland;2021-10-17;F;56;0;1;2722;367954;17877
Syddanmark;2021-10-17;F;38;0;2;2722;367992;17879
Hovedstaden;2021-10-17;M;192;3;9;2725;368184;17888
Midtjylland;2021-10-17;M;20;0;1;2725;368204;17889
Nordjylland;2021-10-17;M;39;0;1;2725;368243;17890
Sjælland;2021-10-17;M;42;0;0;2725;368285;17890
Syddanmark;2021-10-17;M;38;0;1;2725;368323;17891
Hovedstaden;2021-10-18;F;288;1;14;2726;368611;17905
Midtjylland;2021-10-18;F;55;1;3;2727;368666;17908
Nordjylland;2021-10-18;F;37;0;0;2727;368703;17908
Sjælland;2021-10-18;F;99;0;5;2727;368802;17913
Syddanmark;2021-10-18;F;72;0;1;2727;368874;17914
Hovedstaden;2021-10-18;M;217;0;14;2727;369091;17928
Midtjylland;2021-10-18;M;36;0;2;2727;369127;17930
Nordjylland;2021-10-18;M;34;0;3;2727;369161;17933
Sjælland;2021-10-18;M;78;0;2;2727;369239;17935
Syddanmark;2021-10-18;M;57;0;3;2727;369296;17938
Hovedstaden;2021-10-19;F;343;1;9;2728;369639;17947
Midtjylland;2021-10-19;F;58;1;1;2729;369697;17948
Nordjylland;2021-10-19;F;46;0;0;2729;369743;17948
Sjælland;2021-10-19;F;81;0;4;2729;369824;17952
Syddanmark;2021-10-19;F;60;0;1;2729;369884;17953
Hovedstaden;2021-10-19;M;293;1;13;2730;370177;17966
Midtjylland;2021-10-19;M;60;0;2;2730;370237;17968
Nordjylland;2021-10-19;M;34;0;0;2730;370271;17968
Sjælland;2021-10-19;M;85;0;2;2730;370356;17970
Syddanmark;2021-10-19;M;68;0;0;2730;370424;17970
Hovedstaden;2021-10-20;F;357;0;9;2730;370781;17979
Midtjylland;2021-10-20;F;71;0;2;2730;370852;17981
Nordjylland;2021-10-20;F;45;0;2;2730;370897;17983
Sjælland;2021-10-20;F;74;0;3;2730;370971;17986
Syddanmark;2021-10-20;F;97;1;5;2731;371068;17991
Hovedstaden;2021-10-20;M;377;1;13;2732;371445;18004
Midtjylland;2021-10-20;M;72;0;2;2732;371517;18006
Nordjylland;2021-10-20;M;45;0;2;2732;371562;18008
Sjælland;2021-10-20;M;79;0;2;2732;371641;18010
Syddanmark;2021-10-20;M;76;0;2;2732;371717;18012
Hovedstaden;2021-10-21;F;415;1;13;2733;372132;18025
Midtjylland;2021-10-21;F;70;1;3;2734;372202;18028
Nordjylland;2021-10-21;F;55;0;2;2734;372257;18030
Sjælland;2021-10-21;F;128;0;4;2734;372385;18034
Syddanmark;2021-10-21;F;70;0;1;2734;372455;18035
Hovedstaden;2021-10-21;M;359;2;8;2736;372814;18043
Midtjylland;2021-10-21;M;89;0;6;2736;372903;18049
Nordjylland;2021-10-21;M;50;0;0;2736;372953;18049
Sjælland;2021-10-21;M;121;0;5;2736;373074;18054
Syddanmark;2021-10-21;M;59;1;2;2737;373133;18056
Hovedstaden;2021-10-22;F;361;1;11;2738;373494;18067
Midtjylland;2021-10-22;F;70;0;1;2738;373564;18068
Nordjylland;2021-10-22;F;37;0;3;2738;373601;18071
Sjælland;2021-10-22;F;74;0;3;2738;373675;18074
Syddanmark;2021-10-22;F;69;1;0;2739;373744;18074
Hovedstaden;2021-10-22;M;344;1;15;2740;374088;18089
Midtjylland;2021-10-22;M;98;0;2;2740;374186;18091
Nordjylland;2021-10-22;M;49;2;3;2742;374235;18094
Sjælland;2021-10-22;M;63;1;1;2743;374298;18095
Syddanmark;2021-10-22;M;78;0;2;2743;374376;18097
Hovedstaden;2021-10-23;F;369;2;15;2745;374745;18112
Midtjylland;2021-10-23;F;84;0;1;2745;374829;18113
Nordjylland;2021-10-23;F;48;0;2;2745;374877;18115
Sjælland;2021-10-23;F;64;0;2;2745;374941;18117
Syddanmark;2021-10-23;F;67;0;2;2745;375008;18119
Hovedstaden;2021-10-23;M;325;1;16;2746;375333;18135
Midtjylland;2021-10-23;M;78;0;2;2746;375411;18137
Nordjylland;2021-10-23;M;36;0;3;2746;375447;18140
Sjælland;2021-10-23;M;62;2;4;2748;375509;18144
Syddanmark;2021-10-23;M;77;1;3;2749;375586;18147
Hovedstaden;2021-10-24;F;407;0;11;2749;375993;18158
Midtjylland;2021-10-24;F;94;0;4;2749;376087;18162
Nordjylland;2021-10-24;F;50;0;3;2749;376137;18165
Sjælland;2021-10-24;F;93;0;2;2749;376230;18167
Syddanmark;2021-10-24;F;84;0;2;2749;376314;18169
Hovedstaden;2021-10-24;M;390;2;15;2751;376704;18184
Midtjylland;2021-10-24;M;87;0;3;2751;376791;18187
Nordjylland;2021-10-24;M;54;0;1;2751;376845;18188
Sjælland;2021-10-24;M;93;0;3;2751;376938;18191
Syddanmark;2021-10-24;M;104;0;3;2751;377042;18194
Hovedstaden;2021-10-25;F;447;0;16;2751;377489;18210
Midtjylland;2021-10-25;F;98;0;2;2751;377587;18212
Nordjylland;2021-10-25;F;46;0;1;2751;377633;18213
Sjælland;2021-10-25;F;139;1;5;2752;377772;18218
Syddanmark;2021-10-25;F;118;0;2;2752;377890;18220
Hovedstaden;2021-10-25;M;389;1;11;2753;378279;18231
Midtjylland;2021-10-25;M;89;1;3;2754;378368;18234
Nordjylland;2021-10-25;M;39;1;1;2755;378407;18235
Sjælland;2021-10-25;M;153;0;9;2755;378560;18244
Syddanmark;2021-10-25;M;109;0;2;2755;378669;18246
Hovedstaden;2021-10-26;F;545;1;10;2756;379214;18256
Midtjylland;2021-10-26;F;96;0;4;2756;379310;18260
Nordjylland;2021-10-26;F;53;1;0;2757;379363;18260
Sjælland;2021-10-26;F;168;0;5;2757;379531;18265
Syddanmark;2021-10-26;F;124;2;4;2759;379655;18269
Hovedstaden;2021-10-26;M;518;2;19;2761;380173;18288
Midtjylland;2021-10-26;M;79;0;2;2761;380252;18290
Nordjylland;2021-10-26;M;49;0;2;2761;380301;18292
Sjælland;2021-10-26;M;163;0;1;2761;380464;18293
Syddanmark;2021-10-26;M;123;0;4;2761;380587;18297
Hovedstaden;2021-10-27;F;524;2;11;2763;381111;18308
Midtjylland;2021-10-27;F;122;0;2;2763;381233;18310
Nordjylland;2021-10-27;F;46;0;1;2763;381279;18311
Sjælland;2021-10-27;F;128;0;4;2763;381407;18315
Syddanmark;2021-10-27;F;119;0;3;2763;381526;18318
Hovedstaden;2021-10-27;M;509;2;18;2765;382035;18336
Midtjylland;2021-10-27;M;109;1;6;2766;382144;18342
Nordjylland;2021-10-27;M;45;0;4;2766;382189;18346
Sjælland;2021-10-27;M;107;0;2;2766;382296;18348
Syddanmark;2021-10-27;M;134;0;1;2766;382430;18349
Hovedstaden;2021-10-28;F;497;1;20;2767;382927;18369
Midtjylland;2021-10-28;F;126;0;4;2767;383053;18373
Nordjylland;2021-10-28;F;42;0;2;2767;383095;18375
Sjælland;2021-10-28;F;148;0;2;2767;383243;18377
Syddanmark;2021-10-28;F;120;0;3;2767;383363;18380
Hovedstaden;2021-10-28;M;453;3;15;2770;383816;18395
Midtjylland;2021-10-28;M;96;0;2;2770;383912;18397
Nordjylland;2021-10-28;M;40;0;0;2770;383952;18397
Sjælland;2021-10-28;M;138;0;7;2770;384090;18404
Syddanmark;2021-10-28;M;130;0;5;2770;384220;18409
Hovedstaden;2021-10-29;F;421;0;11;2770;384641;18420
Midtjylland;2021-10-29;F;122;1;4;2771;384763;18424
Nordjylland;2021-10-29;F;41;1;1;2772;384804;18425
Sjælland;2021-10-29;F;139;1;4;2773;384943;18429
Syddanmark;2021-10-29;F;114;2;4;2775;385057;18433
Hovedstaden;2021-10-29;M;405;2;13;2777;385462;18446
Midtjylland;2021-10-29;M;91;0;0;2777;385553;18446
Nordjylland;2021-10-29;M;50;0;3;2777;385603;18449
Sjælland;2021-10-29;M;155;0;2;2777;385758;18451
Syddanmark;2021-10-29;M;91;0;3;2777;385849;18454
Hovedstaden;2021-10-30;F;419;2;12;2779;386268;18466
Midtjylland;2021-10-30;F;91;0;1;2779;386359;18467
Nordjylland;2021-10-30;F;41;0;1;2779;386400;18468
Sjælland;2021-10-30;F;89;0;4;2779;386489;18472
Syddanmark;2021-10-30;F;85;1;3;2780;386574;18475
Hovedstaden;2021-10-30;M;367;1;8;2781;386941;18483
Midtjylland;2021-10-30;M;96;0;0;2781;387037;18483
Nordjylland;2021-10-30;M;46;0;5;2781;387083;18488
Sjælland;2021-10-30;M;87;0;3;2781;387170;18491
Syddanmark;2021-10-30;M;92;0;3;2781;387262;18494
Hovedstaden;2021-10-31;F;475;0;13;2781;387737;18507
Midtjylland;2021-10-31;F;121;0;0;2781;387858;18507
Nordjylland;2021-10-31;F;55;0;3;2781;387913;18510
Sjælland;2021-10-31;F;127;0;4;2781;388040;18514
Syddanmark;2021-10-31;F;137;0;4;2781;388177;18518
Hovedstaden;2021-10-31;M;407;1;14;2782;388584;18532
Midtjylland;2021-10-31;M;112;0;2;2782;388696;18534
Nordjylland;2021-10-31;M;67;0;2;2782;388763;18536
Sjælland;2021-10-31;M;102;0;1;2782;388865;18537
Syddanmark;2021-10-31;M;126;0;2;2782;388991;18539
Hovedstaden;2021-11-01;F;532;2;22;2784;389523;18561
Midtjylland;2021-11-01;F;132;0;3;2784;389655;18564
Nordjylland;2021-11-01;F;63;0;2;2784;389718;18566
Sjælland;2021-11-01;F;213;0;4;2784;389931;18570
Syddanmark;2021-11-01;F;154;0;6;2784;390085;18576
Hovedstaden;2021-11-01;M;551;3;19;2787;390636;18595
Midtjylland;2021-11-01;M;151;0;2;2787;390787;18597
Nordjylland;2021-11-01;M;82;0;2;2787;390869;18599
Sjælland;2021-11-01;M;183;0;3;2787;391052;18602
Syddanmark;2021-11-01;M;160;1;4;2788;391212;18606
Hovedstaden;2021-11-02;F;647;0;15;2788;391859;18621
Midtjylland;2021-11-02;F;136;1;3;2789;391995;18624
Nordjylland;2021-11-02;F;77;0;0;2789;392072;18624
Sjælland;2021-11-02;F;159;0;4;2789;392231;18628
Syddanmark;2021-11-02;F;175;0;2;2789;392406;18630
Hovedstaden;2021-11-02;M;556;1;8;2790;392962;18638
Midtjylland;2021-11-02;M;149;1;3;2791;393111;18641
Nordjylland;2021-11-02;M;71;0;2;2791;393182;18643
Sjælland;2021-11-02;M;207;0;5;2791;393389;18648
Syddanmark;2021-11-02;M;165;0;9;2791;393554;18657
Hovedstaden;2021-11-03;F;562;0;14;2791;394116;18671
Midtjylland;2021-11-03;F;175;0;3;2791;394291;18674
Nordjylland;2021-11-03;F;94;0;1;2791;394385;18675
Sjælland;2021-11-03;F;157;0;3;2791;394542;18678
Syddanmark;2021-11-03;F;158;0;4;2791;394700;18682
Hovedstaden;2021-11-03;M;577;0;23;2791;395277;18705
Midtjylland;2021-11-03;M;168;0;2;2791;395445;18707
Nordjylland;2021-11-03;M;76;1;5;2792;395521;18712
Sjælland;2021-11-03;M;187;0;0;2792;395708;18712
Syddanmark;2021-11-03;M;172;2;5;2794;395880;18717
Hovedstaden;2021-11-04;F;554;4;19;2798;396434;18736
Midtjylland;2021-11-04;F;172;0;5;2798;396606;18741
Nordjylland;2021-11-04;F;67;1;1;2799;396673;18742
Sjælland;2021-11-04;F;209;0;5;2799;396882;18747
Syddanmark;2021-11-04;F;166;1;2;2800;397048;18749
Hovedstaden;2021-11-04;M;543;3;17;2803;397591;18766
Midtjylland;2021-11-04;M;153;0;4;2803;397744;18770
Nordjylland;2021-11-04;M;81;0;1;2803;397825;18771
Sjælland;2021-11-04;M;253;1;4;2804;398078;18775
Syddanmark;2021-11-04;M;163;0;5;2804;398241;18780
Hovedstaden;2021-11-05;F;527;2;12;2806;398768;18792
Midtjylland;2021-11-05;F;194;0;1;2806;398962;18793
Nordjylland;2021-11-05;F;72;0;1;2806;399034;18794
Sjælland;2021-11-05;F;173;0;7;2806;399207;18801
Syddanmark;2021-11-05;F;185;0;2;2806;399392;18803
Hovedstaden;2021-11-05;M;493;3;15;2809;399885;18818
Midtjylland;2021-11-05;M;174;0;2;2809;400059;18820
Nordjylland;2021-11-05;M;75;1;2;2810;400134;18822
Sjælland;2021-11-05;M;182;0;8;2810;400316;18830
Syddanmark;2021-11-05;M;153;0;5;2810;400469;18835
Hovedstaden;2021-11-06;F;514;0;16;2810;400983;18851
Midtjylland;2021-11-06;F;138;0;2;2810;401121;18853
Nordjylland;2021-11-06;F;75;1;1;2811;401196;18854
Sjælland;2021-11-06;F;111;1;3;2812;401307;18857
Syddanmark;2021-11-06;F;125;0;1;2812;401432;18858
Hovedstaden;2021-11-06;M;519;1;16;2813;401951;18874
Midtjylland;2021-11-06;M;144;0;2;2813;402095;18876
Nordjylland;2021-11-06;M;62;0;1;2813;402157;18877
Sjælland;2021-11-06;M;141;0;0;2813;402298;18877
Syddanmark;2021-11-06;M;136;0;4;2813;402434;18881
Hovedstaden;2021-11-07;F;640;0;11;2813;403074;18892
Midtjylland;2021-11-07;F;242;0;1;2813;403316;18893
Nordjylland;2021-11-07;F;124;0;0;2813;403440;18893
Sjælland;2021-11-07;F;149;0;7;2813;403589;18900
Syddanmark;2021-11-07;F;191;1;6;2814;403780;18906
Hovedstaden;2021-11-07;M;629;4;22;2818;404409;18928
Midtjylland;2021-11-07;M;195;2;5;2820;404604;18933
Nordjylland;2021-11-07;M;88;1;2;2821;404692;18935
Sjælland;2021-11-07;M;159;0;2;2821;404851;18937
Syddanmark;2021-11-07;M;184;0;3;2821;405035;18940
Hovedstaden;2021-11-08;F;703;2;13;2823;405738;18953
Midtjylland;2021-11-08;F;264;0;2;2823;406002;18955
Nordjylland;2021-11-08;F;126;0;2;2823;406128;18957
Sjælland;2021-11-08;F;313;1;4;2824;406441;18961
Syddanmark;2021-11-08;F;265;0;2;2824;406706;18963
Hovedstaden;2021-11-08;M;739;2;24;2826;407445;18987
Midtjylland;2021-11-08;M;278;0;4;2826;407723;18991
Nordjylland;2021-11-08;M;126;1;3;2827;407849;18994
Sjælland;2021-11-08;M;289;0;6;2827;408138;19000
Syddanmark;2021-11-08;M;240;0;5;2827;408378;19005
Hovedstaden;2021-11-09;F;820;1;18;2828;409198;19023
Midtjylland;2021-11-09;F;300;0;2;2828;409498;19025
Nordjylland;2021-11-09;F;121;0;1;2828;409619;19026
Sjælland;2021-11-09;F;269;1;6;2829;409888;19032
Syddanmark;2021-11-09;F;280;1;5;2830;410168;19037
Hovedstaden;2021-11-09;M;821;0;16;2830;410989;19053
Midtjylland;2021-11-09;M;273;1;1;2831;411262;19054
Nordjylland;2021-11-09;M;142;0;1;2831;411404;19055
Sjælland;2021-11-09;M;271;0;4;2831;411675;19059
Syddanmark;2021-11-09;M;266;1;6;2832;411941;19065
Hovedstaden;2021-11-10;F;875;1;19;2833;412816;19084
Midtjylland;2021-11-10;F;300;0;1;2833;413116;19085
Nordjylland;2021-11-10;F;138;0;4;2833;413254;19089
Sjælland;2021-11-10;F;222;1;4;2834;413476;19093
Syddanmark;2021-11-10;F;259;0;8;2834;413735;19101
Hovedstaden;2021-11-10;M;833;2;11;2836;414568;19112
Midtjylland;2021-11-10;M;284;0;6;2836;414852;19118
Nordjylland;2021-11-10;M;139;3;5;2839;414991;19123
Sjælland;2021-11-10;M;225;1;8;2840;415216;19131
Syddanmark;2021-11-10;M;244;1;8;2841;415460;19139
Hovedstaden;2021-11-11;F;813;2;21;2843;416273;19160
Midtjylland;2021-11-11;F;253;0;3;2843;416526;19163
Nordjylland;2021-11-11;F;117;0;3;2843;416643;19166
Sjælland;2021-11-11;F;299;0;8;2843;416942;19174
Syddanmark;2021-11-11;F;263;0;3;2843;417205;19177
Hovedstaden;2021-11-11;M;772;2;15;2845;417977;19192
Midtjylland;2021-11-11;M;223;0;2;2845;418200;19194
Nordjylland;2021-11-11;M;104;0;3;2845;418304;19197
Sjælland;2021-11-11;M;309;3;11;2848;418613;19208
Syddanmark;2021-11-11;M;292;2;11;2850;418905;19219
Hovedstaden;2021-11-12;F;668;0;9;2850;419573;19228
Midtjylland;2021-11-12;F;225;0;3;2850;419798;19231
Nordjylland;2021-11-12;F;118;0;2;2850;419916;19233
Sjælland;2021-11-12;F;251;0;7;2850;420167;19240
Syddanmark;2021-11-12;F;241;1;8;2851;420408;19248
Hovedstaden;2021-11-12;M;675;2;17;2853;421083;19265
Midtjylland;2021-11-12;M;221;0;3;2853;421304;19268
Nordjylland;2021-11-12;M;130;1;4;2854;421434;19272
Sjælland;2021-11-12;M;232;3;13;2857;421666;19285
Syddanmark;2021-11-12;M;220;3;11;2860;421886;19296
Hovedstaden;2021-11-13;F;764;0;25;2860;422650;19321
Midtjylland;2021-11-13;F;272;0;4;2860;422922;19325
Nordjylland;2021-11-13;F;118;1;1;2861;423040;19326
Sjælland;2021-11-13;F;156;2;4;2863;423196;19330
Syddanmark;2021-11-13;F;215;1;4;2864;423411;19334
Hovedstaden;2021-11-13;M;702;2;12;2866;424113;19346
Midtjylland;2021-11-13;M;210;0;4;2866;424323;19350
Nordjylland;2021-11-13;M;114;0;4;2866;424437;19354
Sjælland;2021-11-13;M;165;1;7;2867;424602;19361
Syddanmark;2021-11-13;M;199;0;5;2867;424801;19366
Hovedstaden;2021-11-14;F;803;4;12;2871;425604;19378
Midtjylland;2021-11-14;F;247;0;8;2871;425851;19386
Nordjylland;2021-11-14;F;128;0;4;2871;425979;19390
Sjælland;2021-11-14;F;186;0;10;2871;426165;19400
Syddanmark;2021-11-14;F;229;0;2;2871;426394;19402
Hovedstaden;2021-11-14;M;762;3;15;2874;427156;19417
Midtjylland;2021-11-14;M;226;0;2;2874;427382;19419
Nordjylland;2021-11-14;M;119;1;5;2875;427501;19424
Sjælland;2021-11-14;M;154;5;13;2880;427655;19437
Syddanmark;2021-11-14;M;225;2;8;2882;427880;19445
Hovedstaden;2021-11-15;F;951;2;19;2884;428831;19464
Midtjylland;2021-11-15;F;338;0;5;2884;429169;19469
Nordjylland;2021-11-15;F;206;2;2;2886;429375;19471
Sjælland;2021-11-15;F;410;2;11;2888;429785;19482
Syddanmark;2021-11-15;F;424;2;12;2890;430209;19494
Hovedstaden;2021-11-15;M;981;2;18;2892;431190;19512
Midtjylland;2021-11-15;M;305;1;9;2893;431495;19521
Nordjylland;2021-11-15;M;158;1;5;2894;431653;19526
Sjælland;2021-11-15;M;386;3;7;2897;432039;19533
Syddanmark;2021-11-15;M;349;2;10;2899;432388;19543
Hovedstaden;2021-11-16;F;911;1;21;2900;433299;19564
Midtjylland;2021-11-16;F;290;2;3;2902;433589;19567
Nordjylland;2021-11-16;F;157;0;4;2902;433746;19571
Sjælland;2021-11-16;F;346;0;7;2902;434092;19578
Syddanmark;2021-11-16;F;345;0;6;2902;434437;19584
Hovedstaden;2021-11-16;M;937;2;21;2904;435374;19605
Midtjylland;2021-11-16;M;300;1;4;2905;435674;19609
Nordjylland;2021-11-16;M;157;0;2;2905;435831;19611
Sjælland;2021-11-16;M;325;1;8;2906;436156;19619
Syddanmark;2021-11-16;M;362;0;12;2906;436518;19631
Hovedstaden;2021-11-17;F;942;3;21;2909;437460;19652
Midtjylland;2021-11-17;F;313;0;10;2909;437773;19662
Nordjylland;2021-11-17;F;168;2;4;2911;437941;19666
Sjælland;2021-11-17;F;267;2;15;2913;438208;19681
Syddanmark;2021-11-17;F;319;1;5;2914;438527;19686
Hovedstaden;2021-11-17;M;908;1;11;2915;439435;19697
Midtjylland;2021-11-17;M;277;0;3;2915;439712;19700
Nordjylland;2021-11-17;M;188;0;1;2915;439900;19701
Sjælland;2021-11-17;M;207;3;7;2918;440107;19708
Syddanmark;2021-11-17;M;357;1;15;2919;440464;19723
Hovedstaden;2021-11-18;F;1002;2;22;2921;441466;19745
Midtjylland;2021-11-18;F;301;0;7;2921;441767;19752
Nordjylland;2021-11-18;F;144;0;1;2921;441911;19753
Sjælland;2021-11-18;F;386;2;11;2923;442297;19764
Syddanmark;2021-11-18;F;338;0;4;2923;442635;19768
Hovedstaden;2021-11-18;M;926;5;26;2928;443561;19794
Midtjylland;2021-11-18;M;290;0;2;2928;443851;19796
Nordjylland;2021-11-18;M;151;0;1;2928;444002;19797
Sjælland;2021-11-18;M;309;1;9;2929;444311;19806
Syddanmark;2021-11-18;M;326;1;6;2930;444637;19812
Hovedstaden;2021-11-19;F;956;0;16;2930;445593;19828
Midtjylland;2021-11-19;F;261;0;3;2930;445854;19831
Nordjylland;2021-11-19;F;141;1;4;2931;445995;19835
Sjælland;2021-11-19;F;319;2;11;2933;446314;19846
Syddanmark;2021-11-19;F;397;3;5;2936;446711;19851
Hovedstaden;2021-11-19;M;977;3;19;2939;447688;19870
Midtjylland;2021-11-19;M;238;1;3;2940;447926;19873
Nordjylland;2021-11-19;M;143;0;4;2940;448069;19877
Sjælland;2021-11-19;M;327;2;13;2942;448396;19890
Syddanmark;2021-11-19;M;342;3;7;2945;448738;19897
Hovedstaden;2021-11-20;F;910;1;21;2946;449648;19918
Midtjylland;2021-11-20;F;293;2;4;2948;449941;19922
Nordjylland;2021-11-20;F;156;0;3;2948;450097;19925
Sjælland;2021-11-20;F;222;3;7;2951;450319;19932
Syddanmark;2021-11-20;F;296;1;8;2952;450615;19940
Hovedstaden;2021-11-20;M;925;1;20;2953;451540;19960
Midtjylland;2021-11-20;M;317;3;6;2956;451857;19966
Nordjylland;2021-11-20;M;137;0;2;2956;451994;19968
Sjælland;2021-11-20;M;170;2;6;2958;452164;19974
Syddanmark;2021-11-20;M;285;1;4;2959;452449;19978
Hovedstaden;2021-11-21;F;879;2;18;2961;453328;19996
Midtjylland;2021-11-21;F;296;1;3;2962;453624;19999
Nordjylland;2021-11-21;F;126;1;3;2963;453750;20002
Sjælland;2021-11-21;F;243;1;5;2964;453993;20007
Syddanmark;2021-11-21;F;316;3;5;2967;454309;20012
Hovedstaden;2021-11-21;M;891;0;12;2967;455200;20024
Midtjylland;2021-11-21;M;284;1;4;2968;455484;20028
Nordjylland;2021-11-21;M;126;0;6;2968;455610;20034
Sjælland;2021-11-21;M;225;0;5;2968;455835;20039
Syddanmark;2021-11-21;M;288;2;7;2970;456123;20046
Hovedstaden;2021-11-22;F;991;0;15;2970;457114;20061
Midtjylland;2021-11-22;F;301;0;3;2970;457415;20064
Nordjylland;2021-11-22;F;153;0;2;2970;457568;20066
Sjælland;2021-11-22;F;415;0;8;2970;457983;20074
Syddanmark;2021-11-22;F;369;1;6;2971;458352;20080
Hovedstaden;2021-11-22;M;1048;2;9;2973;459400;20089
Midtjylland;2021-11-22;M;308;0;8;2973;459708;20097
Nordjylland;2021-11-22;M;158;0;6;2973;459866;20103
Sjælland;2021-11-22;M;399;0;10;2973;460265;20113
Syddanmark;2021-11-22;M;347;2;5;2975;460612;20118
Hovedstaden;2021-11-23;F;1005;2;19;2977;461617;20137
Midtjylland;2021-11-23;F;326;0;1;2977;461943;20138
Nordjylland;2021-11-23;F;170;1;3;2978;462113;20141
Sjælland;2021-11-23;F;426;2;12;2980;462539;20153
Syddanmark;2021-11-23;F;461;2;8;2982;463000;20161
Hovedstaden;2021-11-23;M;1056;2;19;2984;464056;20180
Midtjylland;2021-11-23;M;336;0;5;2984;464392;20185
Nordjylland;2021-11-23;M;146;0;2;2984;464538;20187
Sjælland;2021-11-23;M;376;0;12;2984;464914;20199
Syddanmark;2021-11-23;M;399;1;8;2985;465313;20207
Hovedstaden;2021-11-24;F;994;1;22;2986;466307;20229
Midtjylland;2021-11-24;F;297;0;5;2986;466604;20234
Nordjylland;2021-11-24;F;148;0;5;2986;466752;20239
Sjælland;2021-11-24;F;257;0;4;2986;467009;20243
Syddanmark;2021-11-24;F;354;1;7;2987;467363;20250
Hovedstaden;2021-11-24;M;920;0;24;2987;468283;20274
Midtjylland;2021-11-24;M;306;0;10;2987;468589;20284
Nordjylland;2021-11-24;M;144;1;2;2988;468733;20286
Sjælland;2021-11-24;M;247;0;7;2988;468980;20293
Syddanmark;2021-11-24;M;342;2;8;2990;469322;20301
Hovedstaden;2021-11-25;F;948;1;30;2991;470270;20331
Midtjylland;2021-11-25;F;285;1;5;2992;470555;20336
Nordjylland;2021-11-25;F;128;1;2;2993;470683;20338
Sjælland;2021-11-25;F;339;0;3;2993;471022;20341
Syddanmark;2021-11-25;F;370;1;5;2994;471392;20346
Hovedstaden;2021-11-25;M;875;1;21;2995;472267;20367
Midtjylland;2021-11-25;M;302;2;5;2997;472569;20372
Nordjylland;2021-11-25;M;137;1;3;2998;472706;20375
Sjælland;2021-11-25;M;364;1;9;2999;473070;20384
Syddanmark;2021-11-25;M;330;0;7;2999;473400;20391
Hovedstaden;2021-11-26;F;980;1;21;3000;474380;20412
Midtjylland;2021-11-26;F;314;2;10;3002;474694;20422
Nordjylland;2021-11-26;F;120;1;2;3003;474814;20424
Sjælland;2021-11-26;F;325;2;5;3005;475139;20429
Syddanmark;2021-11-26;F;320;1;11;3006;475459;20440
Hovedstaden;2021-11-26;M;968;4;15;3010;476427;20455
Midtjylland;2021-11-26;M;310;1;5;3011;476737;20460
Nordjylland;2021-11-26;M;157;0;3;3011;476894;20463
Sjælland;2021-11-26;M;341;2;8;3013;477235;20471
Syddanmark;2021-11-26;M;312;2;10;3015;477547;20481
Hovedstaden;2021-11-27;F;898;1;22;3016;478445;20503
Midtjylland;2021-11-27;F;373;0;5;3016;478818;20508
Nordjylland;2021-11-27;F;154;0;1;3016;478972;20509
Sjælland;2021-11-27;F;223;0;3;3016;479195;20512
Syddanmark;2021-11-27;F;308;0;5;3016;479503;20517
Hovedstaden;2021-11-27;M;960;1;17;3017;480463;20534
Midtjylland;2021-11-27;M;329;0;4;3017;480792;20538
Nordjylland;2021-11-27;M;133;0;0;3017;480925;20538
Sjælland;2021-11-27;M;180;0;5;3017;481105;20543
Syddanmark;2021-11-27;M;278;0;6;3017;481383;20549
Hovedstaden;2021-11-28;F;938;1;14;3018;482321;20563
Midtjylland;2021-11-28;F;383;0;7;3018;482704;20570
Nordjylland;2021-11-28;F;144;0;5;3018;482848;20575
Sjælland;2021-11-28;F;212;1;6;3019;483060;20581
Syddanmark;2021-11-28;F;289;1;5;3020;483349;20586
Hovedstaden;2021-11-28;M;975;4;18;3024;484324;20604
Midtjylland;2021-11-28;M;329;1;6;3025;484653;20610
Nordjylland;2021-11-28;M;142;1;4;3026;484795;20614
Sjælland;2021-11-28;M;207;0;4;3026;485002;20618
Syddanmark;2021-11-28;M;260;0;3;3026;485262;20621
Hovedstaden;2021-11-29;F;1124;2;16;3028;486386;20637
Midtjylland;2021-11-29;F;377;2;10;3030;486763;20647
Nordjylland;2021-11-29;F;173;0;1;3030;486936;20648
Sjælland;2021-11-29;F;497;1;9;3031;487433;20657
Syddanmark;2021-11-29;F;433;0;13;3031;487866;20670
Hovedstaden;2021-11-29;M;1057;4;20;3035;488923;20690
Midtjylland;2021-11-29;M;368;0;5;3035;489291;20695
Nordjylland;2021-11-29;M;183;0;2;3035;489474;20697
Sjælland;2021-11-29;M;452;0;7;3035;489926;20704
Syddanmark;2021-11-29;M;402;2;9;3037;490328;20713
Hovedstaden;2021-11-30;F;1228;0;15;3037;491556;20728
Midtjylland;2021-11-30;F;407;0;6;3037;491963;20734
Nordjylland;2021-11-30;F;175;4;7;3041;492138;20741
Sjælland;2021-11-30;F;456;1;9;3042;492594;20750
Syddanmark;2021-11-30;F;454;0;2;3042;493048;20752
Hovedstaden;2021-11-30;M;1127;3;20;3045;494175;20772
Midtjylland;2021-11-30;M;434;0;8;3045;494609;20780
Nordjylland;2021-11-30;M;166;0;5;3045;494775;20785
Sjælland;2021-11-30;M;486;4;12;3049;495261;20797
Syddanmark;2021-11-30;M;469;2;4;3051;495730;20801
Hovedstaden;2021-12-01;F;1054;3;17;3054;496784;20818
Midtjylland;2021-12-01;F;376;0;1;3054;497160;20819
Nordjylland;2021-12-01;F;151;1;6;3055;497311;20825
Sjælland;2021-12-01;F;262;0;11;3055;497573;20836
Syddanmark;2021-12-01;F;398;1;6;3056;497971;20842
Hovedstaden;2021-12-01;M;1039;3;23;3059;499010;20865
Midtjylland;2021-12-01;M;419;0;3;3059;499429;20868
Nordjylland;2021-12-01;M;153;4;7;3063;499582;20875
Sjælland;2021-12-01;M;269;1;5;3064;499851;20880
Syddanmark;2021-12-01;M;404;0;9;3064;500255;20889
Hovedstaden;2021-12-02;F;980;4;22;3068;501235;20911
Midtjylland;2021-12-02;F;364;0;5;3068;501599;20916
Nordjylland;2021-12-02;F;85;0;1;3068;501684;20917
Sjælland;2021-12-02;F;414;1;12;3069;502098;20929
Syddanmark;2021-12-02;F;408;1;6;3070;502506;20935
Hovedstaden;2021-12-02;M;1017;2;20;3072;503523;20955
Midtjylland;2021-12-02;M;397;0;5;3072;503920;20960
Nordjylland;2021-12-02;M;92;0;1;3072;504012;20961
Sjælland;2021-12-02;M;374;1;7;3073;504386;20968
Syddanmark;2021-12-02;M;439;1;11;3074;504825;20979
Hovedstaden;2021-12-03;F;1164;1;22;3075;505989;21001
Midtjylland;2021-12-03;F;412;0;8;3075;506401;21009
Nordjylland;2021-12-03;F;189;0;1;3075;506590;21010
Sjælland;2021-12-03;F;401;0;10;3075;506991;21020
Syddanmark;2021-12-03;F;405;0;14;3075;507396;21034
Hovedstaden;2021-12-03;M;1157;3;19;3078;508553;21053
Midtjylland;2021-12-03;M;440;0;7;3078;508993;21060
Nordjylland;2021-12-03;M;190;0;9;3078;509183;21069
Sjælland;2021-12-03;M;418;2;12;3080;509601;21081
Syddanmark;2021-12-03;M;382;0;8;3080;509983;21089
Hovedstaden;2021-12-04;F;1247;0;20;3080;511230;21109
Midtjylland;2021-12-04;F;466;0;5;3080;511696;21114
Nordjylland;2021-12-04;F;211;0;4;3080;511907;21118
Sjælland;2021-12-04;F;275;0;3;3080;512182;21121
Syddanmark;2021-12-04;F;405;1;6;3081;512587;21127
Hovedstaden;2021-12-04;M;1158;1;22;3082;513745;21149
Midtjylland;2021-12-04;M;438;1;5;3083;514183;21154
Nordjylland;2021-12-04;M;228;0;7;3083;514411;21161
Sjælland;2021-12-04;M;241;1;6;3084;514652;21167
Syddanmark;2021-12-04;M;420;1;3;3085;515072;21170
Hovedstaden;2021-12-05;F;1128;2;22;3087;516200;21192
Midtjylland;2021-12-05;F;404;1;6;3088;516604;21198
Nordjylland;2021-12-05;F;180;0;5;3088;516784;21203
Sjælland;2021-12-05;F;306;1;5;3089;517090;21208
Syddanmark;2021-12-05;F;345;0;3;3089;517435;21211
Hovedstaden;2021-12-05;M;1107;0;15;3089;518542;21226
Midtjylland;2021-12-05;M;479;0;3;3089;519021;21229
Nordjylland;2021-12-05;M;207;0;4;3089;519228;21233
Sjælland;2021-12-05;M;311;1;3;3090;519539;21236
Syddanmark;2021-12-05;M;327;0;8;3090;519866;21244
Hovedstaden;2021-12-06;F;1565;4;26;3094;521431;21270
Midtjylland;2021-12-06;F;582;1;8;3095;522013;21278
Nordjylland;2021-12-06;F;225;0;9;3095;522238;21287
Sjælland;2021-12-06;F;649;0;13;3095;522887;21300
Syddanmark;2021-12-06;F;541;1;10;3096;523428;21310
Hovedstaden;2021-12-06;M;1462;3;19;3099;524890;21329
Midtjylland;2021-12-06;M;617;3;11;3102;525507;21340
Nordjylland;2021-12-06;M;238;1;6;3103;525745;21346
Sjælland;2021-12-06;M;638;1;12;3104;526383;21358
Syddanmark;2021-12-06;M;563;4;7;3108;526946;21365
Hovedstaden;2021-12-07;F;1634;3;30;3111;528580;21395
Midtjylland;2021-12-07;F;623;0;8;3111;529203;21403
Nordjylland;2021-12-07;F;233;0;5;3111;529436;21408
Sjælland;2021-12-07;F;648;1;11;3112;530084;21419
Syddanmark;2021-12-07;F;558;0;11;3112;530642;21430
Hovedstaden;2021-12-07;M;1569;3;31;3115;532211;21461
Midtjylland;2021-12-07;M;630;1;5;3116;532841;21466
Nordjylland;2021-12-07;M;244;1;3;3117;533085;21469
Sjælland;2021-12-07;M;614;1;8;3118;533699;21477
Syddanmark;2021-12-07;M;569;1;13;3119;534268;21490
Hovedstaden;2021-12-08;F;1481;0;18;3119;535749;21508
Midtjylland;2021-12-08;F;612;3;6;3122;536361;21514
Nordjylland;2021-12-08;F;244;0;2;3122;536605;21516
Sjælland;2021-12-08;F;405;2;6;3124;537010;21522
Syddanmark;2021-12-08;F;529;0;6;3124;537539;21528
Hovedstaden;2021-12-08;M;1529;2;29;3126;539068;21557
Midtjylland;2021-12-08;M;627;0;2;3126;539695;21559
Nordjylland;2021-12-08;M;273;0;3;3126;539968;21562
Sjælland;2021-12-08;M;440;2;11;3128;540408;21573
Syddanmark;2021-12-08;M;519;1;5;3129;540927;21578
Hovedstaden;2021-12-09;F;1525;1;27;3130;542452;21605
Midtjylland;2021-12-09;F;593;0;6;3130;543045;21611
Nordjylland;2021-12-09;F;201;0;1;3130;543246;21612
Sjælland;2021-12-09;F;484;0;7;3130;543730;21619
Syddanmark;2021-12-09;F;482;0;8;3130;544212;21627
Hovedstaden;2021-12-09;M;1498;2;21;3132;545710;21648
Midtjylland;2021-12-09;M;621;1;8;3133;546331;21656
Nordjylland;2021-12-09;M;217;0;1;3133;546548;21657
Sjælland;2021-12-09;M;478;0;8;3133;547026;21665
Syddanmark;2021-12-09;M;536;5;7;3138;547562;21672
Hovedstaden;2021-12-10;F;1553;1;29;3139;549115;21701
Midtjylland;2021-12-10;F;593;1;4;3140;549708;21705
Nordjylland;2021-12-10;F;223;0;3;3140;549931;21708
Sjælland;2021-12-10;F;551;1;10;3141;550482;21718
Syddanmark;2021-12-10;F;496;0;7;3141;550978;21725
Hovedstaden;2021-12-10;M;1547;1;22;3142;552525;21747
Midtjylland;2021-12-10;M;614;1;4;3143;553139;21751
Nordjylland;2021-12-10;M;218;1;3;3144;553357;21754
Sjælland;2021-12-10;M;548;1;13;3145;553905;21767
Syddanmark;2021-12-10;M;587;3;13;3148;554492;21780
Hovedstaden;2021-12-11;F;1605;0;29;3148;556097;21809
Midtjylland;2021-12-11;F;628;1;3;3149;556725;21812
Nordjylland;2021-12-11;F;283;0;5;3149;557008;21817
Sjælland;2021-12-11;F;386;0;4;3149;557394;21821
Syddanmark;2021-12-11;F;468;0;4;3149;557862;21825
Hovedstaden;2021-12-11;M;1661;0;18;3149;559523;21843
Midtjylland;2021-12-11;M;623;1;6;3150;560146;21849
Nordjylland;2021-12-11;M;232;0;2;3150;560378;21851
Sjælland;2021-12-11;M;376;1;8;3151;560754;21859
Syddanmark;2021-12-11;M;428;2;4;3153;561182;21863
Hovedstaden;2021-12-12;F;1860;1;21;3154;563042;21884
Midtjylland;2021-12-12;F;749;0;1;3154;563791;21885
Nordjylland;2021-12-12;F;241;0;2;3154;564032;21887
Sjælland;2021-12-12;F;383;2;10;3156;564415;21897
Syddanmark;2021-12-12;F;488;0;4;3156;564903;21901
Hovedstaden;2021-12-12;M;1609;5;23;3161;566512;21924
Midtjylland;2021-12-12;M;692;0;6;3161;567204;21930
Nordjylland;2021-12-12;M;276;1;2;3162;567480;21932
Sjælland;2021-12-12;M;365;1;3;3163;567845;21935
Syddanmark;2021-12-12;M;473;1;5;3164;568318;21940
Hovedstaden;2021-12-13;F;2540;4;38;3168;570858;21978
Midtjylland;2021-12-13;F;898;0;8;3168;571756;21986
Nordjylland;2021-12-13;F;312;0;6;3168;572068;21992
Sjælland;2021-12-13;F;900;0;13;3168;572968;22005
Syddanmark;2021-12-13;F;730;1;5;3169;573698;22010
Hovedstaden;2021-12-13;M;2392;6;28;3175;576090;22038
Midtjylland;2021-12-13;M;885;2;6;3177;576975;22044
Nordjylland;2021-12-13;M;342;2;5;3179;577317;22049
Sjælland;2021-12-13;M;836;1;14;3180;578153;22063
Syddanmark;2021-12-13;M;736;0;8;3180;578889;22071
Hovedstaden;2021-12-14;F;2877;3;26;3183;581766;22097
Midtjylland;2021-12-14;F;919;3;5;3186;582685;22102
Nordjylland;2021-12-14;F;334;0;3;3186;583019;22105
Sjælland;2021-12-14;F;861;1;9;3187;583880;22114
Syddanmark;2021-12-14;F;802;0;6;3187;584682;22120
Hovedstaden;2021-12-14;M;2831;2;25;3189;587513;22145
Midtjylland;2021-12-14;M;873;1;6;3190;588386;22151
Nordjylland;2021-12-14;M;343;0;1;3190;588729;22152
Sjælland;2021-12-14;M;871;3;13;3193;589600;22165
Syddanmark;2021-12-14;M;767;0;8;3193;590367;22173
Hovedstaden;2021-12-15;F;2943;4;45;3197;593310;22218
Midtjylland;2021-12-15;F;909;0;11;3197;594219;22229
Nordjylland;2021-12-15;F;352;1;6;3198;594571;22235
Sjælland;2021-12-15;F;665;0;11;3198;595236;22246
Syddanmark;2021-12-15;F;694;0;5;3198;595930;22251
Hovedstaden;2021-12-15;M;3008;6;44;3204;598938;22295
Midtjylland;2021-12-15;M;900;1;6;3205;599838;22301
Nordjylland;2021-12-15;M;330;0;4;3205;600168;22305
Sjælland;2021-12-15;M;680;3;13;3208;600848;22318
Syddanmark;2021-12-15;M;707;1;5;3209;601555;22323
Hovedstaden;2021-12-16;F;2690;2;31;3211;604245;22354
Midtjylland;2021-12-16;F;866;1;8;3212;605111;22362
Nordjylland;2021-12-16;F;318;0;5;3212;605429;22367
Sjælland;2021-12-16;F;795;1;10;3213;606224;22377
Syddanmark;2021-12-16;F;702;1;7;3214;606926;22384
Hovedstaden;2021-12-16;M;2533;6;33;3220;609459;22417
Midtjylland;2021-12-16;M;867;0;8;3220;610326;22425
Nordjylland;2021-12-16;M;304;0;5;3220;610630;22430
Sjælland;2021-12-16;M;767;3;12;3223;611397;22442
Syddanmark;2021-12-16;M;707;1;9;3224;612104;22451
Hovedstaden;2021-12-17;F;2910;2;28;3226;615014;22479
Midtjylland;2021-12-17;F;905;0;13;3226;615919;22492
Nordjylland;2021-12-17;F;302;0;2;3226;616221;22494
Sjælland;2021-12-17;F;724;2;15;3228;616945;22509
Syddanmark;2021-12-17;F;746;1;8;3229;617691;22517
Hovedstaden;2021-12-17;M;2710;2;30;3231;620401;22547
Midtjylland;2021-12-17;M;914;1;6;3232;621315;22553
Nordjylland;2021-12-17;M;311;0;4;3232;621626;22557
Sjælland;2021-12-17;M;757;2;10;3234;622383;22567
Syddanmark;2021-12-17;M;740;1;12;3235;623123;22579
Hovedstaden;2021-12-18;F;2730;2;29;3237;625853;22608
Midtjylland;2021-12-18;F;943;1;5;3238;626796;22613
Nordjylland;2021-12-18;F;352;0;5;3238;627148;22618
Sjælland;2021-12-18;F;569;0;6;3238;627717;22624
Syddanmark;2021-12-18;F;714;0;9;3238;628431;22633
Hovedstaden;2021-12-18;M;2512;2;21;3240;630943;22654
Midtjylland;2021-12-18;M;974;0;11;3240;631917;22665
Nordjylland;2021-12-18;M;366;0;5;3240;632283;22670
Sjælland;2021-12-18;M;558;0;9;3240;632841;22679
Syddanmark;2021-12-18;M;695;1;5;3241;633536;22684
Hovedstaden;2021-12-19;F;2772;3;32;3244;636308;22716
Midtjylland;2021-12-19;F;1009;0;13;3244;637317;22729
Nordjylland;2021-12-19;F;302;0;4;3244;637619;22733
Sjælland;2021-12-19;F;589;0;4;3244;638208;22737
Syddanmark;2021-12-19;F;650;0;7;3244;638858;22744
Hovedstaden;2021-12-19;M;2648;3;22;3247;641506;22766
Midtjylland;2021-12-19;M;1011;1;6;3248;642517;22772
Nordjylland;2021-12-19;M;361;2;7;3250;642878;22779
Sjælland;2021-12-19;M;550;1;10;3251;643428;22789
Syddanmark;2021-12-19;M;700;0;5;3251;644128;22794
Hovedstaden;2021-12-20;F;3549;1;37;3252;647677;22831
Midtjylland;2021-12-20;F;1094;2;8;3254;648771;22839
Nordjylland;2021-12-20;F;429;1;4;3255;649200;22843
Sjælland;2021-12-20;F;1095;0;13;3255;650295;22856
Syddanmark;2021-12-20;F;866;0;7;3255;651161;22863
Hovedstaden;2021-12-20;M;3364;4;47;3259;654525;22910
Midtjylland;2021-12-20;M;1111;1;8;3260;655636;22918
Nordjylland;2021-12-20;M;416;0;5;3260;656052;22923
Sjælland;2021-12-20;M;1082;0;11;3260;657134;22934
Syddanmark;2021-12-20;M;851;3;7;3263;657985;22941
Hovedstaden;2021-12-21;F;3562;1;46;3264;661547;22987
Midtjylland;2021-12-21;F;1067;2;9;3266;662614;22996
Nordjylland;2021-12-21;F;441;0;5;3266;663055;23001
Sjælland;2021-12-21;F;936;2;15;3268;663991;23016
Syddanmark;2021-12-21;F;863;0;5;3268;664854;23021
Hovedstaden;2021-12-21;M;3470;4;37;3272;668324;23058
Midtjylland;2021-12-21;M;1051;2;12;3274;669375;23070
Nordjylland;2021-12-21;M;430;1;6;3275;669805;23076
Sjælland;2021-12-21;M;966;3;19;3278;670771;23095
Syddanmark;2021-12-21;M;842;0;12;3278;671613;23107
Hovedstaden;2021-12-22;F;3283;1;43;3279;674896;23150
Midtjylland;2021-12-22;F;1006;0;12;3279;675902;23162
Nordjylland;2021-12-22;F;388;2;4;3281;676290;23166
Sjælland;2021-12-22;F;713;2;11;3283;677003;23177
Syddanmark;2021-12-22;F;755;1;13;3284;677758;23190
Hovedstaden;2021-12-22;M;3204;6;40;3290;680962;23230
Midtjylland;2021-12-22;M;1059;1;7;3291;682021;23237
Nordjylland;2021-12-22;M;366;0;3;3291;682387;23240
Sjælland;2021-12-22;M;740;0;8;3291;683127;23248
Syddanmark;2021-12-22;M;693;1;6;3292;683820;23254
Hovedstaden;2021-12-23;F;3408;2;36;3294;687228;23290
Midtjylland;2021-12-23;F;1014;0;13;3294;688242;23303
Nordjylland;2021-12-23;F;429;0;3;3294;688671;23306
Sjælland;2021-12-23;F;872;1;9;3295;689543;23315
Syddanmark;2021-12-23;F;815;0;4;3295;690358;23319
Hovedstaden;2021-12-23;M;3335;5;29;3300;693693;23348
Midtjylland;2021-12-23;M;1118;0;3;3300;694811;23351
Nordjylland;2021-12-23;M;480;0;2;3300;695291;23353
Sjælland;2021-12-23;M;881;4;19;3304;696172;23372
Syddanmark;2021-12-23;M;834;1;1;3305;697006;23373
Hovedstaden;2021-12-24;F;1533;0;27;3305;698539;23400
Midtjylland;2021-12-24;F;781;0;7;3305;699320;23407
Nordjylland;2021-12-24;F;249;0;2;3305;699569;23409
Sjælland;2021-12-24;F;421;0;9;3305;699990;23418
Syddanmark;2021-12-24;F;630;1;5;3306;700620;23423
Hovedstaden;2021-12-24;M;1483;1;13;3307;702103;23436
Midtjylland;2021-12-24;M;857;0;7;3307;702960;23443
Nordjylland;2021-12-24;M;289;0;10;3307;703249;23453
Sjælland;2021-12-24;M;474;2;9;3309;703723;23462
Syddanmark;2021-12-24;M;649;0;2;3309;704372;23464
Hovedstaden;2021-12-25;F;1871;5;40;3314;706243;23504
Midtjylland;2021-12-25;F;882;0;5;3314;707125;23509
Nordjylland;2021-12-25;F;295;0;2;3314;707420;23511
Sjælland;2021-12-25;F;529;2;8;3316;707949;23519
Syddanmark;2021-12-25;F;680;1;10;3317;708629;23529
Hovedstaden;2021-12-25;M;1638;6;32;3323;710267;23561
Midtjylland;2021-12-25;M;875;0;8;3323;711142;23569
Nordjylland;2021-12-25;M;281;0;3;3323;711423;23572
Sjælland;2021-12-25;M;486;3;11;3326;711909;23583
Syddanmark;2021-12-25;M;657;1;7;3327;712566;23590
Hovedstaden;2021-12-26;F;2484;1;36;3328;715050;23626
Midtjylland;2021-12-26;F;1357;0;4;3328;716407;23630
Nordjylland;2021-12-26;F;378;0;3;3328;716785;23633
Sjælland;2021-12-26;F;769;1;11;3329;717554;23644
Syddanmark;2021-12-26;F;1050;0;10;3329;718604;23654
Hovedstaden;2021-12-26;M;2169;4;27;3333;720773;23681
Midtjylland;2021-12-26;M;1270;2;8;3335;722043;23689
Nordjylland;2021-12-26;M;393;1;2;3336;722436;23691
Sjælland;2021-12-26;M;643;0;9;3336;723079;23700
Syddanmark;2021-12-26;M;954;0;7;3336;724033;23707
Hovedstaden;2021-12-27;F;5562;6;73;3342;729595;23780
Midtjylland;2021-12-27;F;2113;3;19;3345;731708;23799
Nordjylland;2021-12-27;F;979;0;8;3345;732687;23807
Sjælland;2021-12-27;F;1878;2;22;3347;734565;23829
Syddanmark;2021-12-27;F;1706;1;14;3348;736271;23843
Hovedstaden;2021-12-27;M;5167;2;55;3350;741438;23898
Midtjylland;2021-12-27;M;1954;4;12;3354;743392;23910
Nordjylland;2021-12-27;M;1036;0;5;3354;744428;23915
Sjælland;2021-12-27;M;1720;2;23;3356;746148;23938
Syddanmark;2021-12-27;M;1746;0;20;3356;747894;23958
Hovedstaden;2021-12-28;F;5390;7;80;3363;753284;24038
Midtjylland;2021-12-28;F;2147;0;19;3363;755431;24057
Nordjylland;2021-12-28;F;910;0;6;3363;756341;24063
Sjælland;2021-12-28;F;1680;4;29;3367;758021;24092
Syddanmark;2021-12-28;F;1796;4;22;3371;759817;24114
Hovedstaden;2021-12-28;M;4875;3;45;3374;764692;24159
Midtjylland;2021-12-28;M;2073;3;13;3377;766765;24172
Nordjylland;2021-12-28;M;960;0;6;3377;767725;24178
Sjælland;2021-12-28;M;1636;0;24;3377;769361;24202
Syddanmark;2021-12-28;M;1709;1;11;3378;771070;24213
Hovedstaden;2021-12-29;F;4153;0;51;3378;775223;24264
Midtjylland;2021-12-29;F;1673;3;16;3381;776896;24280
Nordjylland;2021-12-29;F;835;2;10;3383;777731;24290
Sjælland;2021-12-29;F;1269;0;18;3383;779000;24308
Syddanmark;2021-12-29;F;1378;2;8;3385;780378;24316
Hovedstaden;2021-12-29;M;3873;6;50;3391;784251;24366
Midtjylland;2021-12-29;M;1659;1;8;3392;785910;24374
Nordjylland;2021-12-29;M;816;1;5;3393;786726;24379
Sjælland;2021-12-29;M;1212;1;12;3394;787938;24391
Syddanmark;2021-12-29;M;1371;0;8;3394;789309;24399
Hovedstaden;2021-12-30;F;4378;12;55;3406;793687;24454
Midtjylland;2021-12-30;F;1878;2;15;3408;795565;24469
Nordjylland;2021-12-30;F;955;1;8;3409;796520;24477
Sjælland;2021-12-30;F;1516;4;22;3413;798036;24499
Syddanmark;2021-12-30;F;1698;1;14;3414;799734;24513
Hovedstaden;2021-12-30;M;4067;3;40;3417;803801;24553
Midtjylland;2021-12-30;M;1881;2;12;3419;805682;24565
Nordjylland;2021-12-30;M;899;3;12;3422;806581;24577
Sjælland;2021-12-30;M;1421;3;15;3425;808002;24592
Syddanmark;2021-12-30;M;1641;1;12;3426;809643;24604
Hovedstaden;2021-12-31;F;1819;1;34;3427;811462;24638
Midtjylland;2021-12-31;F;1130;0;4;3427;812592;24642
Nordjylland;2021-12-31;F;461;1;1;3428;813053;24643
Sjælland;2021-12-31;F;648;0;16;3428;813701;24659
Syddanmark;2021-12-31;F;1111;0;15;3428;814812;24674
Hovedstaden;2021-12-31;M;1661;1;22;3429;816473;24696
Midtjylland;2021-12-31;M;1186;2;13;3431;817659;24709
Nordjylland;2021-12-31;M;472;0;2;3431;818131;24711
Sjælland;2021-12-31;M;637;2;11;3433;818768;24722
Syddanmark;2021-12-31;M;1091;3;7;3436;819859;24729
Hovedstaden;2022-01-01;F;1785;2;36;3438;821644;24765
Midtjylland;2022-01-01;F;1072;1;6;3439;822716;24771
Nordjylland;2022-01-01;F;341;0;6;3439;823057;24777
Sjælland;2022-01-01;F;666;0;15;3439;823723;24792
Syddanmark;2022-01-01;F;926;1;16;3440;824649;24808
Hovedstaden;2022-01-01;M;1589;4;24;3444;826238;24832
Midtjylland;2022-01-01;M;1047;1;8;3445;827285;24840
Nordjylland;2022-01-01;M;323;0;3;3445;827608;24843
Sjælland;2022-01-01;M;584;2;7;3447;828192;24850
Syddanmark;2022-01-01;M;826;1;9;3448;829018;24859
Hovedstaden;2022-01-02;F;4968;2;55;3450;833986;24914
Midtjylland;2022-01-02;F;2129;0;13;3450;836115;24927
Nordjylland;2022-01-02;F;1153;1;8;3451;837268;24935
Sjælland;2022-01-02;F;1073;2;18;3453;838341;24953
Syddanmark;2022-01-02;F;1499;0;8;3453;839840;24961
Hovedstaden;2022-01-02;M;4631;2;43;3455;844471;25004
Midtjylland;2022-01-02;M;2110;0;9;3455;846581;25013
Nordjylland;2022-01-02;M;1265;1;13;3456;847846;25026
Sjælland;2022-01-02;M;1054;3;20;3459;848900;25046
Syddanmark;2022-01-02;M;1500;1;8;3460;850400;25054
Hovedstaden;2022-01-03;F;5956;6;62;3466;856356;25116
Midtjylland;2022-01-03;F;2656;3;16;3469;859012;25132
Nordjylland;2022-01-03;F;1152;2;10;3471;860164;25142
Sjælland;2022-01-03;F;2049;1;20;3472;862213;25162
Syddanmark;2022-01-03;F;2385;4;12;3476;864598;25174
Hovedstaden;2022-01-03;M;5215;5;40;3481;869813;25214
Midtjylland;2022-01-03;M;2626;3;20;3484;872439;25234
Nordjylland;2022-01-03;M;1115;2;8;3486;873554;25242
Sjælland;2022-01-03;M;2046;1;17;3487;875600;25259
Syddanmark;2022-01-03;M;2332;0;10;3487;877932;25269
Hovedstaden;2022-01-04;F;5227;1;54;3488;883159;25323
Midtjylland;2022-01-04;F;2517;2;20;3490;885676;25343
Nordjylland;2022-01-04;F;1069;0;6;3490;886745;25349
Sjælland;2022-01-04;F;1746;3;20;3493;888491;25369
Syddanmark;2022-01-04;F;2307;1;9;3494;890798;25378
Hovedstaden;2022-01-04;M;4860;6;52;3500;895658;25430
Midtjylland;2022-01-04;M;2594;0;16;3500;898252;25446
Nordjylland;2022-01-04;M;1138;0;10;3500;899390;25456
Sjælland;2022-01-04;M;1773;1;15;3501;901163;25471
Syddanmark;2022-01-04;M;2452;3;11;3504;903615;25482
Hovedstaden;2022-01-05;F;3901;6;44;3510;907516;25526
Midtjylland;2022-01-05;F;1937;0;9;3510;909453;25535
Nordjylland;2022-01-05;F;845;0;7;3510;910298;25542
Sjælland;2022-01-05;F;1061;0;21;3510;911359;25563
Syddanmark;2022-01-05;F;1662;2;14;3512;913021;25577
Hovedstaden;2022-01-05;M;3762;1;33;3513;916783;25610
Midtjylland;2022-01-05;M;2098;2;12;3515;918881;25622
Nordjylland;2022-01-05;M;964;0;8;3515;919845;25630
Sjælland;2022-01-05;M;1108;1;15;3516;920953;25645
Syddanmark;2022-01-05;M;1744;1;7;3517;922697;25652
Hovedstaden;2022-01-06;F;3464;2;37;3519;926161;25689
Midtjylland;2022-01-06;F;1732;0;7;3519;927893;25696
Nordjylland;2022-01-06;F;713;0;2;3519;928606;25698
Sjælland;2022-01-06;F;1221;2;19;3521;929827;25717
Syddanmark;2022-01-06;F;1489;1;11;3522;931316;25728
Hovedstaden;2022-01-06;M;3225;4;33;3526;934541;25761
Midtjylland;2022-01-06;M;1630;1;9;3527;936171;25770
Nordjylland;2022-01-06;M;713;1;2;3528;936884;25772
Sjælland;2022-01-06;M;1182;0;20;3528;938066;25792
Syddanmark;2022-01-06;M;1409;2;12;3530;939475;25804
Hovedstaden;2022-01-07;F;3029;2;42;3532;942504;25846
Midtjylland;2022-01-07;F;1688;0;8;3532;944192;25854
Nordjylland;2022-01-07;F;665;0;3;3532;944857;25857
Sjælland;2022-01-07;F;1079;0;15;3532;945936;25872
Syddanmark;2022-01-07;F;1421;0;8;3532;947357;25880
Hovedstaden;2022-01-07;M;2872;3;32;3535;950229;25912
Midtjylland;2022-01-07;M;1653;1;12;3536;951882;25924
Nordjylland;2022-01-07;M;661;0;6;3536;952543;25930
Sjælland;2022-01-07;M;1044;1;7;3537;953587;25937
Syddanmark;2022-01-07;M;1435;4;11;3541;955022;25948
Hovedstaden;2022-01-08;F;3148;2;39;3543;958170;25987
Midtjylland;2022-01-08;F;1693;1;9;3544;959863;25996
Nordjylland;2022-01-08;F;623;1;0;3545;960486;25996
Sjælland;2022-01-08;F;870;1;13;3546;961356;26009
Syddanmark;2022-01-08;F;1105;1;7;3547;962461;26016
Hovedstaden;2022-01-08;M;3022;4;22;3551;965483;26038
Midtjylland;2022-01-08;M;1486;1;3;3552;966969;26041
Nordjylland;2022-01-08;M;670;1;6;3553;967639;26047
Sjælland;2022-01-08;M;793;2;8;3555;968432;26055
Syddanmark;2022-01-08;M;1168;0;7;3555;969600;26062
Hovedstaden;2022-01-09;F;3819;5;42;3560;973419;26104
Midtjylland;2022-01-09;F;2006;0;12;3560;975425;26116
Nordjylland;2022-01-09;F;782;0;3;3560;976207;26119
Sjælland;2022-01-09;F;972;1;7;3561;977179;26126
Syddanmark;2022-01-09;F;1504;1;14;3562;978683;26140
Hovedstaden;2022-01-09;M;3397;1;26;3563;982080;26166
Midtjylland;2022-01-09;M;1911;1;10;3564;983991;26176
Nordjylland;2022-01-09;M;786;0;6;3564;984777;26182
Sjælland;2022-01-09;M;911;0;9;3564;985688;26191
Syddanmark;2022-01-09;M;1375;2;11;3566;987063;26202
Hovedstaden;2022-01-10;F;5027;4;45;3570;992090;26247
Midtjylland;2022-01-10;F;2492;1;14;3571;994582;26261
Nordjylland;2022-01-10;F;1013;2;12;3573;995595;26273
Sjælland;2022-01-10;F;1910;2;23;3575;997505;26296
Syddanmark;2022-01-10;F;2396;1;16;3576;999901;26312
Hovedstaden;2022-01-10;M;4703;2;40;3578;1004604;26352
Midtjylland;2022-01-10;M;2347;3;13;3581;1006951;26365
Nordjylland;2022-01-10;M;977;1;7;3582;1007928;26372
Sjælland;2022-01-10;M;1734;0;15;3582;1009662;26387
Syddanmark;2022-01-10;M;2253;1;12;3583;1011915;26399
Hovedstaden;2022-01-11;F;5160;5;64;3588;1017075;26463
Midtjylland;2022-01-11;F;2458;2;16;3590;1019533;26479
Nordjylland;2022-01-11;F;1073;1;9;3591;1020606;26488
Sjælland;2022-01-11;F;1622;0;32;3591;1022228;26520
Syddanmark;2022-01-11;F;2312;1;14;3592;1024540;26534
Hovedstaden;2022-01-11;M;4601;2;42;3594;1029141;26576
Midtjylland;2022-01-11;M;2317;2;9;3596;1031458;26585
Nordjylland;2022-01-11;M;993;1;3;3597;1032451;26588
Sjælland;2022-01-11;M;1548;4;14;3601;1033999;26602
Syddanmark;2022-01-11;M;2273;1;12;3602;1036272;26614
Hovedstaden;2022-01-12;F;4978;4;47;3606;1041250;26661
Midtjylland;2022-01-12;F;2667;1;17;3607;1043917;26678
Nordjylland;2022-01-12;F;1089;2;11;3609;1045006;26689
Sjælland;2022-01-12;F;1460;0;16;3609;1046466;26705
Syddanmark;2022-01-12;F;2239;2;19;3611;1048705;26724
Hovedstaden;2022-01-12;M;4557;5;44;3616;1053262;26768
Midtjylland;2022-01-12;M;2576;2;13;3618;1055838;26781
Nordjylland;2022-01-12;M;1088;0;4;3618;1056926;26785
Sjælland;2022-01-12;M;1381;2;21;3620;1058307;26806
Syddanmark;2022-01-12;M;2163;0;15;3620;1060470;26821
Hovedstaden;2022-01-13;F;5034;7;50;3627;1065504;26871
Midtjylland;2022-01-13;F;2746;3;22;3630;1068250;26893
Nordjylland;2022-01-13;F;989;2;11;3632;1069239;26904
Sjælland;2022-01-13;F;1894;1;19;3633;1071133;26923
Syddanmark;2022-01-13;F;2574;0;10;3633;1073707;26933
Hovedstaden;2022-01-13;M;4546;6;51;3639;1078253;26984
Midtjylland;2022-01-13;M;2627;0;12;3639;1080880;26996
Nordjylland;2022-01-13;M;974;1;2;3640;1081854;26998
Sjælland;2022-01-13;M;1757;4;16;3644;1083611;27014
Syddanmark;2022-01-13;M;2320;1;14;3645;1085931;27028
Hovedstaden;2022-01-14;F;5624;7;58;3652;1091555;27086
Midtjylland;2022-01-14;F;3016;2;20;3654;1094571;27106
Nordjylland;2022-01-14;F;1073;0;10;3654;1095644;27116
Sjælland;2022-01-14;F;1896;0;17;3654;1097540;27133
Syddanmark;2022-01-14;F;2727;1;19;3655;1100267;27152
Hovedstaden;2022-01-14;M;4987;7;43;3662;1105254;27195
Midtjylland;2022-01-14;M;2852;0;17;3662;1108106;27212
Nordjylland;2022-01-14;M;1031;3;9;3665;1109137;27221
Sjælland;2022-01-14;M;1831;0;22;3665;1110968;27243
Syddanmark;2022-01-14;M;2576;1;8;3666;1113544;27251
Hovedstaden;2022-01-15;F;5788;2;53;3668;1119332;27304
Midtjylland;2022-01-15;F;3265;1;16;3669;1122597;27320
Nordjylland;2022-01-15;F;1115;1;6;3670;1123712;27326
Sjælland;2022-01-15;F;1515;2;20;3672;1125227;27346
Syddanmark;2022-01-15;F;2341;2;8;3674;1127568;27354
Hovedstaden;2022-01-15;M;5261;3;26;3677;1132829;27380
Midtjylland;2022-01-15;M;3072;1;15;3678;1135901;27395
Nordjylland;2022-01-15;M;1042;0;6;3678;1136943;27401
Sjælland;2022-01-15;M;1376;2;14;3680;1138319;27415
Syddanmark;2022-01-15;M;2151;2;14;3682;1140470;27429
Hovedstaden;2022-01-16;F;6122;4;60;3686;1146592;27489
Midtjylland;2022-01-16;F;3751;0;19;3686;1150343;27508
Nordjylland;2022-01-16;F;1332;2;4;3688;1151675;27512
Sjælland;2022-01-16;F;1786;2;17;3690;1153461;27529
Syddanmark;2022-01-16;F;2849;2;19;3692;1156310;27548
Hovedstaden;2022-01-16;M;5509;6;55;3698;1161819;27603
Midtjylland;2022-01-16;M;3327;1;22;3699;1165146;27625
Nordjylland;2022-01-16;M;1249;0;8;3699;1166395;27633
Sjælland;2022-01-16;M;1517;2;23;3701;1167912;27656
Syddanmark;2022-01-16;M;2510;3;16;3704;1170422;27672
Hovedstaden;2022-01-17;F;8277;2;76;3706;1178699;27748
Midtjylland;2022-01-17;F;4557;1;24;3707;1183256;27772
Nordjylland;2022-01-17;F;1832;2;17;3709;1185088;27789
Sjælland;2022-01-17;F;3560;1;26;3710;1188648;27815
Syddanmark;2022-01-17;F;4897;1;27;3711;1193545;27842
Hovedstaden;2022-01-17;M;7450;4;53;3715;1200995;27895
Midtjylland;2022-01-17;M;4269;0;23;3715;1205264;27918
Nordjylland;2022-01-17;M;1774;1;7;3716;1207038;27925
Sjælland;2022-01-17;M;3230;0;22;3716;1210268;27947
Syddanmark;2022-01-17;M;4313;5;20;3721;1214581;27967
Hovedstaden;2022-01-18;F;8240;3;60;3724;1222821;28027
Midtjylland;2022-01-18;F;4481;1;23;3725;1227302;28050
Nordjylland;2022-01-18;F;1701;2;11;3727;1229003;28061
Sjælland;2022-01-18;F;3273;1;29;3728;1232276;28090
Syddanmark;2022-01-18;F;4665;1;20;3729;1236941;28110
Hovedstaden;2022-01-18;M;7567;4;62;3733;1244508;28172
Midtjylland;2022-01-18;M;4138;2;23;3735;1248646;28195
Nordjylland;2022-01-18;M;1632;1;7;3736;1250278;28202
Sjælland;2022-01-18;M;2974;0;11;3736;1253252;28213
Syddanmark;2022-01-18;M;4345;2;16;3738;1257597;28229
Hovedstaden;2022-01-19;F;7796;3;70;3741;1265393;28299
Midtjylland;2022-01-19;F;4556;3;28;3744;1269949;28327
Nordjylland;2022-01-19;F;1694;0;9;3744;1271643;28336
Sjælland;2022-01-19;F;2663;1;35;3745;1274306;28371
Syddanmark;2022-01-19;F;4195;2;23;3747;1278501;28394
Hovedstaden;2022-01-19;M;7111;5;53;3752;1285612;28447
Midtjylland;2022-01-19;M;4325;3;16;3755;1289937;28463
Nordjylland;2022-01-19;M;1615;1;5;3756;1291552;28468
Sjælland;2022-01-19;M;2463;0;13;3756;1294015;28481
Syddanmark;2022-01-19;M;3930;2;18;3758;1297945;28499
Hovedstaden;2022-01-20;F;7349;9;84;3767;1305294;28583
Midtjylland;2022-01-20;F;4233;2;20;3769;1309527;28603
Nordjylland;2022-01-20;F;1684;1;13;3770;1311211;28616
Sjælland;2022-01-20;F;3248;3;26;3773;1314459;28642
Syddanmark;2022-01-20;F;4318;1;18;3774;1318777;28660
Hovedstaden;2022-01-20;M;6555;7;55;3781;1325332;28715
Midtjylland;2022-01-20;M;3877;1;16;3782;1329209;28731
Nordjylland;2022-01-20;M;1619;2;7;3784;1330828;28738
Sjælland;2022-01-20;M;3100;1;27;3785;1333928;28765
Syddanmark;2022-01-20;M;3974;2;21;3787;1337902;28786
Hovedstaden;2022-01-21;F;7260;6;74;3793;1345162;28860
Midtjylland;2022-01-21;F;4541;2;15;3795;1349703;28875
Nordjylland;2022-01-21;F;1602;4;17;3799;1351305;28892
Sjælland;2022-01-21;F;3081;0;23;3799;1354386;28915
Syddanmark;2022-01-21;F;4340;1;20;3800;1358726;28935
Hovedstaden;2022-01-21;M;6496;2;49;3802;1365222;28984
Midtjylland;2022-01-21;M;4201;1;22;3803;1369423;29006
Nordjylland;2022-01-21;M;1464;0;6;3803;1370887;29012
Sjælland;2022-01-21;M;2891;1;24;3804;1373778;29036
Syddanmark;2022-01-21;M;4064;5;14;3809;1377842;29050
Hovedstaden;2022-01-22;F;7324;8;83;3817;1385166;29133
Midtjylland;2022-01-22;F;4478;1;20;3818;1389644;29153
Nordjylland;2022-01-22;F;1761;1;12;3819;1391405;29165
Sjælland;2022-01-22;F;2291;2;20;3821;1393696;29185
Syddanmark;2022-01-22;F;3462;1;13;3822;1397158;29198
Hovedstaden;2022-01-22;M;6661;2;50;3824;1403819;29248
Midtjylland;2022-01-22;M;4175;1;10;3825;1407994;29258
Nordjylland;2022-01-22;M;1628;0;4;3825;1409622;29262
Sjælland;2022-01-22;M;2094;1;24;3826;1411716;29286
Syddanmark;2022-01-22;M;3198;0;16;3826;1414914;29302
Hovedstaden;2022-01-23;F;7908;6;86;3832;1422822;29388
Midtjylland;2022-01-23;F;4949;2;22;3834;1427771;29410
Nordjylland;2022-01-23;F;1921;0;4;3834;1429692;29414
Sjælland;2022-01-23;F;2605;1;24;3835;1432297;29438
Syddanmark;2022-01-23;F;4055;2;21;3837;1436352;29459
Hovedstaden;2022-01-23;M;7162;3;49;3840;1443514;29508
Midtjylland;2022-01-23;M;4519;2;16;3842;1448033;29524
Nordjylland;2022-01-23;M;1685;2;12;3844;1449718;29536
Sjælland;2022-01-23;M;2229;2;25;3846;1451947;29561
Syddanmark;2022-01-23;M;3563;1;15;3847;1455510;29576
Hovedstaden;2022-01-24;F;9552;6;89;3853;1465062;29665
Midtjylland;2022-01-24;F;6398;0;31;3853;1471460;29696
Nordjylland;2022-01-24;F;2668;2;8;3855;1474128;29704
Sjælland;2022-01-24;F;4919;3;44;3858;1479047;29748
Syddanmark;2022-01-24;F;6481;2;36;3860;1485528;29784
Hovedstaden;2022-01-24;M;8663;4;59;3864;1494191;29843
Midtjylland;2022-01-24;M;5859;1;25;3865;1500050;29868
Nordjylland;2022-01-24;M;2554;1;8;3866;1502604;29876
Sjælland;2022-01-24;M;4352;4;41;3870;1506956;29917
Syddanmark;2022-01-24;M;5861;3;25;3873;1512817;29942
Hovedstaden;2022-01-25;F;8503;5;72;3878;1521320;30014
Midtjylland;2022-01-25;F;5921;2;35;3880;1527241;30049
Nordjylland;2022-01-25;F;2578;2;11;3882;1529819;30060
Sjælland;2022-01-25;F;3943;2;35;3884;1533762;30095
Syddanmark;2022-01-25;F;6118;7;34;3891;1539880;30129
Hovedstaden;2022-01-25;M;7682;7;68;3898;1547562;30197
Midtjylland;2022-01-25;M;5390;1;13;3899;1552952;30210
Nordjylland;2022-01-25;M;2438;1;10;3900;1555390;30220
Sjælland;2022-01-25;M;3759;2;36;3902;1559149;30256
Syddanmark;2022-01-25;M;5581;3;28;3905;1564730;30284
Hovedstaden;2022-01-26;F;7167;5;87;3910;1571897;30371
Midtjylland;2022-01-26;F;5702;3;30;3913;1577599;30401
Nordjylland;2022-01-26;F;2318;2;14;3915;1579917;30415
Sjælland;2022-01-26;F;2899;2;21;3917;1582816;30436
Syddanmark;2022-01-26;F;4950;5;26;3922;1587766;30462
Hovedstaden;2022-01-26;M;6529;3;59;3925;1594295;30521
Midtjylland;2022-01-26;M;5222;1;26;3926;1599517;30547
Nordjylland;2022-01-26;M;2199;0;10;3926;1601716;30557
Sjælland;2022-01-26;M;2674;3;18;3929;1604390;30575
Syddanmark;2022-01-26;M;4793;3;31;3932;1609183;30606
Hovedstaden;2022-01-27;F;6441;7;74;3939;1615624;30680
Midtjylland;2022-01-27;F;5079;0;32;3939;1620703;30712
Nordjylland;2022-01-27;F;1985;0;6;3939;1622688;30718
Sjælland;2022-01-27;F;3461;3;38;3942;1626149;30756
Syddanmark;2022-01-27;F;4868;2;29;3944;1631017;30785
Hovedstaden;2022-01-27;M;5733;7;57;3951;1636750;30842
Midtjylland;2022-01-27;M;4622;2;20;3953;1641372;30862
Nordjylland;2022-01-27;M;1903;1;14;3954;1643275;30876
Sjælland;2022-01-27;M;3126;2;18;3956;1646401;30894
Syddanmark;2022-01-27;M;4370;2;21;3958;1650771;30915
Hovedstaden;2022-01-28;F;5660;1;52;3959;1656431;30967
Midtjylland;2022-01-28;F;5085;2;28;3961;1661516;30995
Nordjylland;2022-01-28;F;1963;0;11;3961;1663479;31006
Sjælland;2022-01-28;F;2881;2;24;3963;1666360;31030
Syddanmark;2022-01-28;F;4442;2;22;3965;1670802;31052
Hovedstaden;2022-01-28;M;5111;7;52;3972;1675913;31104
Midtjylland;2022-01-28;M;4493;0;21;3972;1680406;31125
Nordjylland;2022-01-28;M;1809;1;8;3973;1682215;31133
Sjælland;2022-01-28;M;2680;4;22;3977;1684895;31155
Syddanmark;2022-01-28;M;4017;1;23;3978;1688912;31178
Hovedstaden;2022-01-29;F;5145;1;43;3979;1694057;31221
Midtjylland;2022-01-29;F;2965;1;22;3980;1697022;31243
Nordjylland;2022-01-29;F;1849;1;8;3981;1698871;31251
Sjælland;2022-01-29;F;2078;0;25;3981;1700949;31276
Syddanmark;2022-01-29;F;3732;1;30;3982;1704681;31306
Hovedstaden;2022-01-29;M;4535;3;53;3985;1709216;31359
Midtjylland;2022-01-29;M;2605;2;14;3987;1711821;31373
Nordjylland;2022-01-29;M;1786;0;4;3987;1713607;31377
Sjælland;2022-01-29;M;1804;2;19;3989;1715411;31396
Syddanmark;2022-01-29;M;3422;4;16;3993;1718833;31412
Hovedstaden;2022-01-30;F;4819;6;65;3999;1723652;31477
Midtjylland;2022-01-30;F;4674;1;21;4000;1728326;31498
Nordjylland;2022-01-30;F;2582;1;19;4001;1730908;31517
Sjælland;2022-01-30;F;2197;0;25;4001;1733105;31542
Syddanmark;2022-01-30;F;4197;2;27;4003;1737302;31569
Hovedstaden;2022-01-30;M;4389;1;44;4004;1741691;31613
Midtjylland;2022-01-30;M;4018;4;23;4008;1745709;31636
Nordjylland;2022-01-30;M;2324;2;15;4010;1748033;31651
Sjælland;2022-01-30;M;1907;2;25;4012;1749940;31676
Syddanmark;2022-01-30;M;3788;2;14;4014;1753728;31690
Hovedstaden;2022-01-31;F;8374;8;98;4022;1762102;31788
Midtjylland;2022-01-31;F;7912;5;37;4027;1770014;31825
Nordjylland;2022-01-31;F;2770;1;18;4028;1772784;31843
Sjælland;2022-01-31;F;4490;3;42;4031;1777274;31885
Syddanmark;2022-01-31;F;6452;1;32;4032;1783726;31917
Hovedstaden;2022-01-31;M;7373;13;69;4045;1791099;31986
Midtjylland;2022-01-31;M;6813;5;36;4050;1797912;32022
Nordjylland;2022-01-31;M;2449;2;13;4052;1800361;32035
Sjælland;2022-01-31;M;3909;1;40;4053;1804270;32075
Syddanmark;2022-01-31;M;5853;5;26;4058;1810123;32101
Hovedstaden;2022-02-01;F;6213;5;66;4063;1816336;32167
Midtjylland;2022-02-01;F;6329;6;35;4069;1822665;32202
Nordjylland;2022-02-01;F;2456;2;16;4071;1825121;32218
Sjælland;2022-02-01;F;3240;3;39;4074;1828361;32257
Syddanmark;2022-02-01;F;5860;2;49;4076;1834221;32306
Hovedstaden;2022-02-01;M;5612;7;57;4083;1839833;32363
Midtjylland;2022-02-01;M;5822;8;19;4091;1845655;32382
Nordjylland;2022-02-01;M;2298;3;20;4094;1847953;32402
Sjælland;2022-02-01;M;2989;4;41;4098;1850942;32443
Syddanmark;2022-02-01;M;5301;3;24;4101;1856243;32467
Hovedstaden;2022-02-02;F;5473;3;71;4104;1861716;32538
Midtjylland;2022-02-02;F;5914;3;31;4107;1867630;32569
Nordjylland;2022-02-02;F;2505;2;17;4109;1870135;32586
Sjælland;2022-02-02;F;2356;1;40;4110;1872491;32626
Syddanmark;2022-02-02;F;4686;2;32;4112;1877177;32658
Hovedstaden;2022-02-02;M;4978;4;55;4116;1882155;32713
Midtjylland;2022-02-02;M;5505;0;18;4116;1887660;32731
Nordjylland;2022-02-02;M;2286;1;14;4117;1889946;32745
Sjælland;2022-02-02;M;2270;3;43;4120;1892216;32788
Syddanmark;2022-02-02;M;4505;7;35;4127;1896721;32823
Hovedstaden;2022-02-03;F;5254;7;65;4134;1901975;32888
Midtjylland;2022-02-03;F;5578;3;33;4137;1907553;32921
Nordjylland;2022-02-03;F;2184;3;18;4140;1909737;32939
Sjælland;2022-02-03;F;3038;3;28;4143;1912775;32967
Syddanmark;2022-02-03;F;4982;5;37;4148;1917757;33004
Hovedstaden;2022-02-03;M;4486;5;47;4153;1922243;33051
Midtjylland;2022-02-03;M;5144;3;24;4156;1927387;33075
Nordjylland;2022-02-03;M;2090;2;14;4158;1929477;33089
Sjælland;2022-02-03;M;2678;6;34;4164;1932155;33123
Syddanmark;2022-02-03;M;4316;5;34;4169;1936471;33157
Hovedstaden;2022-02-04;F;4669;4;62;4173;1941140;33219
Midtjylland;2022-02-04;F;5322;1;38;4174;1946462;33257
Nordjylland;2022-02-04;F;2216;0;18;4174;1948678;33275
Sjælland;2022-02-04;F;2663;4;33;4178;1951341;33308
Syddanmark;2022-02-04;F;4728;3;30;4181;1956069;33338
Hovedstaden;2022-02-04;M;4040;4;58;4185;1960109;33396
Midtjylland;2022-02-04;M;4794;2;25;4187;1964903;33421
Nordjylland;2022-02-04;M;2072;1;20;4188;1966975;33441
Sjælland;2022-02-04;M;2407;2;39;4190;1969382;33480
Syddanmark;2022-02-04;M;4282;6;34;4196;1973664;33514
Hovedstaden;2022-02-05;F;4473;0;52;4196;1978137;33566
Midtjylland;2022-02-05;F;5269;1;29;4197;1983406;33595
Nordjylland;2022-02-05;F;2425;1;12;4198;1985831;33607
Sjælland;2022-02-05;F;1830;3;25;4201;1987661;33632
Syddanmark;2022-02-05;F;3887;3;35;4204;1991548;33667
Hovedstaden;2022-02-05;M;3828;2;33;4206;1995376;33700
Midtjylland;2022-02-05;M;4614;5;24;4211;1999990;33724
Nordjylland;2022-02-05;M;2233;3;12;4214;2002223;33736
Sjælland;2022-02-05;M;1650;1;24;4215;2003873;33760
Syddanmark;2022-02-05;M;3395;5;36;4220;2007268;33796
Hovedstaden;2022-02-06;F;5969;3;69;4223;2013237;33865
Midtjylland;2022-02-06;F;6518;2;34;4225;2019755;33899
Nordjylland;2022-02-06;F;2936;2;20;4227;2022691;33919
Sjælland;2022-02-06;F;2319;2;28;4229;2025010;33947
Syddanmark;2022-02-06;F;4986;3;38;4232;2029996;33985
Hovedstaden;2022-02-06;M;5049;1;49;4233;2035045;34034
Midtjylland;2022-02-06;M;5577;1;29;4234;2040622;34063
Nordjylland;2022-02-06;M;2746;2;12;4236;2043368;34075
Sjælland;2022-02-06;M;1962;4;29;4240;2045330;34104
Syddanmark;2022-02-06;M;4173;7;27;4247;2049503;34131
Hovedstaden;2022-02-07;F;7409;7;93;4254;2056912;34224
Midtjylland;2022-02-07;F;8258;4;50;4258;2065170;34274
Nordjylland;2022-02-07;F;3487;2;16;4260;2068657;34290
Sjælland;2022-02-07;F;4470;4;42;4264;2073127;34332
Syddanmark;2022-02-07;F;7317;8;58;4272;2080444;34390
Hovedstaden;2022-02-07;M;6224;3;65;4275;2086668;34455
Midtjylland;2022-02-07;M;6886;7;43;4282;2093554;34498
Nordjylland;2022-02-07;M;3104;2;18;4284;2096658;34516
Sjælland;2022-02-07;M;3924;7;52;4291;2100582;34568
Syddanmark;2022-02-07;M;6270;7;48;4298;2106852;34616
Hovedstaden;2022-02-08;F;6935;4;83;4302;2113787;34699
Midtjylland;2022-02-08;F;8043;1;55;4303;2121830;34754
Nordjylland;2022-02-08;F;3659;3;14;4306;2125489;34768
Sjælland;2022-02-08;F;3733;7;43;4313;2129222;34811
Syddanmark;2022-02-08;F;7127;6;47;4319;2136349;34858
Hovedstaden;2022-02-08;M;6129;3;57;4322;2142478;34915
Midtjylland;2022-02-08;M;7078;5;41;4327;2149556;34956
Nordjylland;2022-02-08;M;3178;5;18;4332;2152734;34974
Sjælland;2022-02-08;M;3434;4;38;4336;2156168;35012
Syddanmark;2022-02-08;M;6264;4;41;4340;2162432;35053
Hovedstaden;2022-02-09;F;6078;6;92;4346;2168510;35145
Midtjylland;2022-02-09;F;7615;2;46;4348;2176125;35191
Nordjylland;2022-02-09;F;3574;3;24;4351;2179699;35215
Sjælland;2022-02-09;F;2941;2;38;4353;2182640;35253
Syddanmark;2022-02-09;F;5948;5;45;4358;2188588;35298
Hovedstaden;2022-02-09;M;5480;8;78;4366;2194068;35376
Midtjylland;2022-02-09;M;7062;8;40;4374;2201130;35416
Nordjylland;2022-02-09;M;3287;2;24;4376;2204417;35440
Sjælland;2022-02-09;M;2737;1;38;4377;2207154;35478
Syddanmark;2022-02-09;M;5532;6;52;4383;2212686;35530
Hovedstaden;2022-02-10;F;5304;4;67;4387;2217990;35597
Midtjylland;2022-02-10;F;6320;2;46;4389;2224310;35643
Nordjylland;2022-02-10;F;3085;4;27;4393;2227395;35670
Sjælland;2022-02-10;F;3189;2;30;4395;2230584;35700
Syddanmark;2022-02-10;F;5731;6;39;4401;2236315;35739
Hovedstaden;2022-02-10;M;4524;4;65;4405;2240839;35804
Midtjylland;2022-02-10;M;5744;9;49;4414;2246583;35853
Nordjylland;2022-02-10;M;3057;1;21;4415;2249640;35874
Sjælland;2022-02-10;M;2934;5;22;4420;2252574;35896
Syddanmark;2022-02-10;M;5223;9;50;4429;2257797;35946
Hovedstaden;2022-02-11;F;4208;6;59;4435;2262005;36005
Midtjylland;2022-02-11;F;5817;2;34;4437;2267822;36039
Nordjylland;2022-02-11;F;2926;2;27;4439;2270748;36066
Sjælland;2022-02-11;F;2634;8;33;4447;2273382;36099
Syddanmark;2022-02-11;F;4723;5;36;4452;2278105;36135
Hovedstaden;2022-02-11;M;3719;4;71;4456;2281824;36206
Midtjylland;2022-02-11;M;5294;7;50;4463;2287118;36256
Nordjylland;2022-02-11;M;2742;1;21;4464;2289860;36277
Sjælland;2022-02-11;M;2496;3;34;4467;2292356;36311
Syddanmark;2022-02-11;M;4333;5;35;4472;2296689;36346
Hovedstaden;2022-02-12;F;3683;3;38;4475;2300372;36384
Midtjylland;2022-02-12;F;4859;3;46;4478;2305231;36430
Nordjylland;2022-02-12;F;2761;2;20;4480;2307992;36450
Sjælland;2022-02-12;F;1707;2;26;4482;2309699;36476
Syddanmark;2022-02-12;F;4057;5;32;4487;2313756;36508
Hovedstaden;2022-02-12;M;3296;2;48;4489;2317052;36556
Midtjylland;2022-02-12;M;4542;3;31;4492;2321594;36587
Nordjylland;2022-02-12;M;2439;2;18;4494;2324033;36605
Sjælland;2022-02-12;M;1506;0;25;4494;2325539;36630
Syddanmark;2022-02-12;M;3776;4;32;4498;2329315;36662
Hovedstaden;2022-02-13;F;4102;3;70;4501;2333417;36732
Midtjylland;2022-02-13;F;5516;1;33;4502;2338933;36765
Nordjylland;2022-02-13;F;2911;3;24;4505;2341844;36789
Sjælland;2022-02-13;F;1912;3;27;4508;2343756;36816
Syddanmark;2022-02-13;F;4305;2;36;4510;2348061;36852
Hovedstaden;2022-02-13;M;3587;4;50;4514;2351648;36902
Midtjylland;2022-02-13;M;4925;4;35;4518;2356573;36937
Nordjylland;2022-02-13;M;2709;2;16;4520;2359282;36953
Sjælland;2022-02-13;M;1694;5;18;4525;2360976;36971
Syddanmark;2022-02-13;M;3929;3;43;4528;2364905;37014
Hovedstaden;2022-02-14;F;5433;10;88;4538;2370338;37102
Midtjylland;2022-02-14;F;6130;4;56;4542;2376468;37158
Nordjylland;2022-02-14;F;3419;5;29;4547;2379887;37187
Sjælland;2022-02-14;F;3484;4;55;4551;2383371;37242
Syddanmark;2022-02-14;F;5601;4;60;4555;2388972;37302
Hovedstaden;2022-02-14;M;4539;4;78;4559;2393511;37380
Midtjylland;2022-02-14;M;5405;11;43;4570;2398916;37423
Nordjylland;2022-02-14;M;3135;3;34;4573;2402051;37457
Sjælland;2022-02-14;M;2991;3;50;4576;2405042;37507
Syddanmark;2022-02-14;M;5081;11;58;4587;2410123;37565
Hovedstaden;2022-02-15;F;5165;5;65;4592;2415288;37630
Midtjylland;2022-02-15;F;5897;4;55;4596;2421185;37685
Nordjylland;2022-02-15;F;3077;5;29;4601;2424262;37714
Sjælland;2022-02-15;F;3040;4;35;4605;2427302;37749
Syddanmark;2022-02-15;F;5083;9;42;4614;2432385;37791
Hovedstaden;2022-02-15;M;4403;5;71;4619;2436788;37862
Midtjylland;2022-02-15;M;5266;6;43;4625;2442054;37905
Nordjylland;2022-02-15;M;2779;5;37;4630;2444833;37942
Sjælland;2022-02-15;M;2662;4;52;4634;2447495;37994
Syddanmark;2022-02-15;M;4635;6;39;4640;2452130;38033
Hovedstaden;2022-02-16;F;4382;3;65;4643;2456512;38098
Midtjylland;2022-02-16;F;5214;5;61;4648;2461726;38159
Nordjylland;2022-02-16;F;2841;2;18;4650;2464567;38177
Sjælland;2022-02-16;F;2095;1;39;4651;2466662;38216
Syddanmark;2022-02-16;F;4313;6;40;4657;2470975;38256
Hovedstaden;2022-02-16;M;3918;6;68;4663;2474893;38324
Midtjylland;2022-02-16;M;4843;4;47;4667;2479736;38371
Nordjylland;2022-02-16;M;2579;5;30;4672;2482315;38401
Sjælland;2022-02-16;M;1907;1;25;4673;2484222;38426
Syddanmark;2022-02-16;M;3965;9;45;4682;2488187;38471
Hovedstaden;2022-02-17;F;3957;8;89;4690;2492144;38560
Midtjylland;2022-02-17;F;4878;1;47;4691;2497022;38607
Nordjylland;2022-02-17;F;2443;3;24;4694;2499465;38631
Sjælland;2022-02-17;F;2513;11;39;4705;2501978;38670
Syddanmark;2022-02-17;F;4253;13;52;4718;2506231;38722
Hovedstaden;2022-02-17;M;3594;7;45;4725;2509825;38767
Midtjylland;2022-02-17;M;4206;2;36;4727;2514031;38803
Nordjylland;2022-02-17;M;2280;4;24;4731;2516311;38827
Sjælland;2022-02-17;M;2154;2;39;4733;2518465;38866
Syddanmark;2022-02-17;M;3790;9;53;4742;2522255;38919
Hovedstaden;2022-02-18;F;3093;7;50;4749;2525348;38969
Midtjylland;2022-02-18;F;3778;7;42;4756;2529126;39011
Nordjylland;2022-02-18;F;2061;3;29;4759;2531187;39040
Sjælland;2022-02-18;F;1816;1;35;4760;2533003;39075
Syddanmark;2022-02-18;F;3450;5;49;4765;2536453;39124
Hovedstaden;2022-02-18;M;2557;3;47;4768;2539010;39171
Midtjylland;2022-02-18;M;3430;5;29;4773;2542440;39200
Nordjylland;2022-02-18;M;1854;5;28;4778;2544294;39228
Sjælland;2022-02-18;M;1614;5;29;4783;2545908;39257
Syddanmark;2022-02-18;M;3091;10;39;4793;2548999;39296
Hovedstaden;2022-02-19;F;3119;2;41;4795;2552118;39337
Midtjylland;2022-02-19;F;3857;3;27;4798;2555975;39364
Nordjylland;2022-02-19;F;1820;4;25;4802;2557795;39389
Sjælland;2022-02-19;F;1256;3;26;4805;2559051;39415
Syddanmark;2022-02-19;F;3154;3;31;4808;2562205;39446
Hovedstaden;2022-02-19;M;2633;5;26;4813;2564838;39472
Midtjylland;2022-02-19;M;3441;5;31;4818;2568279;39503
Nordjylland;2022-02-19;M;1696;4;28;4822;2569975;39531
Sjælland;2022-02-19;M;1115;4;22;4826;2571090;39553
Syddanmark;2022-02-19;M;2836;2;27;4828;2573926;39580
Hovedstaden;2022-02-20;F;3787;5;55;4833;2577713;39635
Midtjylland;2022-02-20;F;4692;4;40;4837;2582405;39675
Nordjylland;2022-02-20;F;1991;2;21;4839;2584396;39696
Sjælland;2022-02-20;F;1478;4;17;4843;2585874;39713
Syddanmark;2022-02-20;F;3735;4;41;4847;2589609;39754
Hovedstaden;2022-02-20;M;3245;7;53;4854;2592854;39807
Midtjylland;2022-02-20;M;4359;1;36;4855;2597213;39843
Nordjylland;2022-02-20;M;1813;4;29;4859;2599026;39872
Sjælland;2022-02-20;M;1362;1;30;4860;2600388;39902
Syddanmark;2022-02-20;M;3219;1;27;4861;2603607;39929
Hovedstaden;2022-02-21;F;4134;7;79;4868;2607741;40008
Midtjylland;2022-02-21;F;4658;8;41;4876;2612399;40049
Nordjylland;2022-02-21;F;2247;3;21;4879;2614646;40070
Sjælland;2022-02-21;F;2526;2;33;4881;2617172;40103
Syddanmark;2022-02-21;F;4207;6;47;4887;2621379;40150
Hovedstaden;2022-02-21;M;3504;9;72;4896;2624883;40222
Midtjylland;2022-02-21;M;4157;10;42;4906;2629040;40264
Nordjylland;2022-02-21;M;1910;2;31;4908;2630950;40295
Sjælland;2022-02-21;M;2203;8;37;4916;2633153;40332
Syddanmark;2022-02-21;M;3617;6;48;4922;2636770;40380
Hovedstaden;2022-02-22;F;3555;5;48;4927;2640325;40428
Midtjylland;2022-02-22;F;3725;3;35;4930;2644050;40463
Nordjylland;2022-02-22;F;2048;6;20;4936;2646098;40483
Sjælland;2022-02-22;F;1789;2;25;4938;2647887;40508
Syddanmark;2022-02-22;F;3342;4;36;4942;2651229;40544
Hovedstaden;2022-02-22;M;3003;3;53;4945;2654232;40597
Midtjylland;2022-02-22;M;3422;7;35;4952;2657654;40632
Nordjylland;2022-02-22;M;1828;6;28;4958;2659482;40660
Sjælland;2022-02-22;M;1565;5;39;4963;2661047;40699
Syddanmark;2022-02-22;M;3080;7;37;4970;2664127;40736
Hovedstaden;2022-02-23;F;3004;6;50;4976;2667131;40786
Midtjylland;2022-02-23;F;3292;7;38;4983;2670423;40824
Nordjylland;2022-02-23;F;1802;2;19;4985;2672225;40843
Sjælland;2022-02-23;F;1451;2;36;4987;2673676;40879
Syddanmark;2022-02-23;F;2749;11;42;4998;2676425;40921
Hovedstaden;2022-02-23;M;2667;7;56;5005;2679092;40977
Midtjylland;2022-02-23;M;3056;5;38;5010;2682148;41015
Nordjylland;2022-02-23;M;1620;2;30;5012;2683768;41045
Sjælland;2022-02-23;M;1276;2;30;5014;2685044;41075
Syddanmark;2022-02-23;M;2476;4;44;5018;2687520;41119
Hovedstaden;2022-02-24;F;2571;0;60;5018;2690091;41179
Midtjylland;2022-02-24;F;2832;4;27;5022;2692923;41206
Nordjylland;2022-02-24;F;1604;3;19;5025;2694527;41225
Sjælland;2022-02-24;F;1463;1;30;5026;2695990;41255
Syddanmark;2022-02-24;F;2581;7;39;5033;2698571;41294
Hovedstaden;2022-02-24;M;2220;9;55;5042;2700791;41349
Midtjylland;2022-02-24;M;2372;2;27;5044;2703163;41376
Nordjylland;2022-02-24;M;1339;3;25;5047;2704502;41401
Sjælland;2022-02-24;M;1339;7;35;5054;2705841;41436
Syddanmark;2022-02-24;M;2276;9;36;5063;2708117;41472
Hovedstaden;2022-02-25;F;1996;2;33;5065;2710113;41505
Midtjylland;2022-02-25;F;2376;1;29;5066;2712489;41534
Nordjylland;2022-02-25;F;1276;6;23;5072;2713765;41557
Sjælland;2022-02-25;F;1133;0;19;5072;2714898;41576
Syddanmark;2022-02-25;F;2066;2;32;5074;2716964;41608
Hovedstaden;2022-02-25;M;1734;2;41;5076;2718698;41649
Midtjylland;2022-02-25;M;2066;4;30;5080;2720764;41679
Nordjylland;2022-02-25;M;1144;3;28;5083;2721908;41707
Sjælland;2022-02-25;M;1034;2;24;5085;2722942;41731
Syddanmark;2022-02-25;M;1764;6;35;5091;2724706;41766
Hovedstaden;2022-02-26;F;1751;5;33;5096;2726457;41799
Midtjylland;2022-02-26;F;2066;1;30;5097;2728523;41829
Nordjylland;2022-02-26;F;1150;3;14;5100;2729673;41843
Sjælland;2022-02-26;F;797;0;17;5100;2730470;41860
Syddanmark;2022-02-26;F;1575;2;24;5102;2732045;41884
Hovedstaden;2022-02-26;M;1562;3;34;5105;2733607;41918
Midtjylland;2022-02-26;M;1787;2;25;5107;2735394;41943
Nordjylland;2022-02-26;M;1006;1;14;5108;2736400;41957
Sjælland;2022-02-26;M;707;6;18;5114;2737107;41975
Syddanmark;2022-02-26;M;1447;6;25;5120;2738554;42000
Hovedstaden;2022-02-27;F;2138;1;25;5121;2740692;42025
Midtjylland;2022-02-27;F;2460;0;21;5121;2743152;42046
Nordjylland;2022-02-27;F;1466;1;19;5122;2744618;42065
Sjælland;2022-02-27;F;1087;1;17;5123;2745705;42082
Syddanmark;2022-02-27;F;1972;2;18;5125;2747677;42100
Hovedstaden;2022-02-27;M;1749;6;41;5131;2749426;42141
Midtjylland;2022-02-27;M;2129;3;17;5134;2751555;42158
Nordjylland;2022-02-27;M;1237;3;16;5137;2752792;42174
Sjælland;2022-02-27;M;894;0;18;5137;2753686;42192
Syddanmark;2022-02-27;M;1727;2;27;5139;2755413;42219
Hovedstaden;2022-02-28;F;2727;5;47;5144;2758140;42266
Midtjylland;2022-02-28;F;3063;6;26;5150;2761203;42292
Nordjylland;2022-02-28;F;1393;1;20;5151;2762596;42312
Sjælland;2022-02-28;F;1688;5;26;5156;2764284;42338
Syddanmark;2022-02-28;F;2677;6;37;5162;2766961;42375
Hovedstaden;2022-02-28;M;2291;8;61;5170;2769252;42436
Midtjylland;2022-02-28;M;2556;5;36;5175;2771808;42472
Nordjylland;2022-02-28;M;1327;3;19;5178;2773135;42491
Sjælland;2022-02-28;M;1398;4;25;5182;2774533;42516
Syddanmark;2022-02-28;M;2353;8;50;5190;2776886;42566
Hovedstaden;2022-03-01;F;2368;3;46;5193;2779254;42612
Midtjylland;2022-03-01;F;2687;6;41;5199;2781941;42653
Nordjylland;2022-03-01;F;1291;1;22;5200;2783232;42675
Sjælland;2022-03-01;F;1115;3;19;5203;2784347;42694
Syddanmark;2022-03-01;F;2336;3;24;5206;2786683;42718
Hovedstaden;2022-03-01;M;1972;9;50;5215;2788655;42768
Midtjylland;2022-03-01;M;2319;6;35;5221;2790974;42803
Nordjylland;2022-03-01;M;1138;3;22;5224;2792112;42825
Sjælland;2022-03-01;M;1001;1;15;5225;2793113;42840
Syddanmark;2022-03-01;M;2061;7;37;5232;2795174;42877
Hovedstaden;2022-03-02;F;2202;3;62;5235;2797376;42939
Midtjylland;2022-03-02;F;2640;1;26;5236;2800016;42965
Nordjylland;2022-03-02;F;1195;2;16;5238;2801211;42981
Sjælland;2022-03-02;F;1071;1;28;5239;2802282;43009
Syddanmark;2022-03-02;F;2105;5;28;5244;2804387;43037
Hovedstaden;2022-03-02;M;1933;5;30;5249;2806320;43067
Midtjylland;2022-03-02;M;2272;4;28;5253;2808592;43095
Nordjylland;2022-03-02;M;1096;3;16;5256;2809688;43111
Sjælland;2022-03-02;M;964;2;24;5258;2810652;43135
Syddanmark;2022-03-02;M;1861;5;26;5263;2812513;43161
Hovedstaden;2022-03-03;F;1996;6;56;5269;2814509;43217
Midtjylland;2022-03-03;F;2212;4;21;5273;2816721;43238
Nordjylland;2022-03-03;F;963;5;18;5278;2817684;43256
Sjælland;2022-03-03;F;1120;4;22;5282;2818804;43278
Syddanmark;2022-03-03;F;2187;7;25;5289;2820991;43303
Hovedstaden;2022-03-03;M;1624;3;44;5292;2822615;43347
Midtjylland;2022-03-03;M;1986;3;29;5295;2824601;43376
Nordjylland;2022-03-03;M;852;4;19;5299;2825453;43395
Sjælland;2022-03-03;M;992;3;36;5302;2826445;43431
Syddanmark;2022-03-03;M;1827;6;31;5308;2828272;43462
Hovedstaden;2022-03-04;F;1702;2;38;5310;2829974;43500
Midtjylland;2022-03-04;F;1900;2;24;5312;2831874;43524
Nordjylland;2022-03-04;F;849;3;24;5315;2832723;43548
Sjælland;2022-03-04;F;924;2;26;5317;2833647;43574
Syddanmark;2022-03-04;F;1794;3;26;5320;2835441;43600
Hovedstaden;2022-03-04;M;1405;8;47;5328;2836846;43647
Midtjylland;2022-03-04;M;1697;5;28;5333;2838543;43675
Nordjylland;2022-03-04;M;759;4;12;5337;2839302;43687
Sjælland;2022-03-04;M;844;2;30;5339;2840146;43717
Syddanmark;2022-03-04;M;1509;6;29;5345;2841655;43746
Hovedstaden;2022-03-05;F;1424;0;23;5345;2843079;43769
Midtjylland;2022-03-05;F;1663;6;14;5351;2844742;43783
Nordjylland;2022-03-05;F;760;1;15;5352;2845502;43798
Sjælland;2022-03-05;F;554;1;7;5353;2846056;43805
Syddanmark;2022-03-05;F;1428;4;18;5357;2847484;43823
Hovedstaden;2022-03-05;M;1191;0;24;5357;2848675;43847
Midtjylland;2022-03-05;M;1410;2;24;5359;2850085;43871
Nordjylland;2022-03-05;M;702;2;19;5361;2850787;43890
Sjælland;2022-03-05;M;518;4;22;5365;2851305;43912
Syddanmark;2022-03-05;M;1282;0;31;5365;2852587;43943
Hovedstaden;2022-03-06;F;1703;3;41;5368;2854290;43984
Midtjylland;2022-03-06;F;2013;4;23;5372;2856303;44007
Nordjylland;2022-03-06;F;946;2;11;5374;2857249;44018
Sjælland;2022-03-06;F;758;1;16;5375;2858007;44034
Syddanmark;2022-03-06;F;1688;6;28;5381;2859695;44062
Hovedstaden;2022-03-06;M;1465;2;20;5383;2861160;44082
Midtjylland;2022-03-06;M;1720;5;27;5388;2862880;44109
Nordjylland;2022-03-06;M;832;3;13;5391;2863712;44122
Sjælland;2022-03-06;M;655;3;22;5394;2864367;44144
Syddanmark;2022-03-06;M;1506;6;28;5400;2865873;44172
Hovedstaden;2022-03-07;F;2151;4;37;5404;2868024;44209
Midtjylland;2022-03-07;F;2387;5;29;5409;2870411;44238
Nordjylland;2022-03-07;F;1030;1;25;5410;2871441;44263
Sjælland;2022-03-07;F;1249;8;27;5418;2872690;44290
Syddanmark;2022-03-07;F;2128;8;26;5426;2874818;44316
Hovedstaden;2022-03-07;M;1762;3;45;5429;2876580;44361
Midtjylland;2022-03-07;M;2044;1;33;5430;2878624;44394
Nordjylland;2022-03-07;M;852;5;22;5435;2879476;44416
Sjælland;2022-03-07;M;1071;5;27;5440;2880547;44443
Syddanmark;2022-03-07;M;1889;3;36;5443;2882436;44479
Hovedstaden;2022-03-08;F;1973;0;36;5443;2884409;44515
Midtjylland;2022-03-08;F;2158;4;32;5447;2886567;44547
Nordjylland;2022-03-08;F;971;2;9;5449;2887538;44556
Sjælland;2022-03-08;F;1080;3;20;5452;2888618;44576
Syddanmark;2022-03-08;F;2151;6;32;5458;2890769;44608
Hovedstaden;2022-03-08;M;1847;6;34;5464;2892616;44642
Midtjylland;2022-03-08;M;1909;3;29;5467;2894525;44671
Nordjylland;2022-03-08;M;834;4;16;5471;2895359;44687
Sjælland;2022-03-08;M;963;1;22;5472;2896322;44709
Syddanmark;2022-03-08;M;1852;2;37;5474;2898174;44746
Hovedstaden;2022-03-09;F;1797;2;36;5476;2899971;44782
Midtjylland;2022-03-09;F;1913;3;24;5479;2901884;44806
Nordjylland;2022-03-09;F;965;2;21;5481;2902849;44827
Sjælland;2022-03-09;F;993;0;24;5481;2903842;44851
Syddanmark;2022-03-09;F;1745;6;27;5487;2905587;44878
Hovedstaden;2022-03-09;M;1608;4;42;5491;2907195;44920
Midtjylland;2022-03-09;M;1746;2;17;5493;2908941;44937
Nordjylland;2022-03-09;M;812;2;15;5495;2909753;44952
Sjælland;2022-03-09;M;903;3;18;5498;2910656;44970
Syddanmark;2022-03-09;M;1633;5;31;5503;2912289;45001
Hovedstaden;2022-03-10;F;1538;5;34;5508;2913827;45035
Midtjylland;2022-03-10;F;1613;2;30;5510;2915440;45065
Nordjylland;2022-03-10;F;695;6;14;5516;2916135;45079
Sjælland;2022-03-10;F;881;4;20;5520;2917016;45099
Syddanmark;2022-03-10;F;1637;7;36;5527;2918653;45135
Hovedstaden;2022-03-10;M;1348;2;29;5529;2920001;45164
Midtjylland;2022-03-10;M;1390;1;12;5530;2921391;45176
Nordjylland;2022-03-10;M;603;2;8;5532;2921994;45184
Sjælland;2022-03-10;M;782;1;25;5533;2922776;45209
Syddanmark;2022-03-10;M;1483;6;33;5539;2924259;45242
Hovedstaden;2022-03-11;F;972;1;21;5540;2925231;45263
Midtjylland;2022-03-11;F;1051;3;19;5543;2926282;45282
Nordjylland;2022-03-11;F;483;1;13;5544;2926765;45295
Sjælland;2022-03-11;F;557;1;14;5545;2927322;45309
Syddanmark;2022-03-11;F;1034;1;23;5546;2928356;45332
Hovedstaden;2022-03-11;M;872;0;24;5546;2929228;45356
Midtjylland;2022-03-11;M;938;2;18;5548;2930166;45374
Nordjylland;2022-03-11;M;438;1;14;5549;2930604;45388
Sjælland;2022-03-11;M;476;5;23;5554;2931080;45411
Syddanmark;2022-03-11;M;944;4;31;5558;2932024;45442
Hovedstaden;2022-03-12;F;850;1;23;5559;2932874;45465
Midtjylland;2022-03-12;F;855;3;15;5562;2933729;45480
Nordjylland;2022-03-12;F;425;0;7;5562;2934154;45487
Sjælland;2022-03-12;F;400;2;16;5564;2934554;45503
Syddanmark;2022-03-12;F;857;3;17;5567;2935411;45520
Hovedstaden;2022-03-12;M;699;0;25;5567;2936110;45545
Midtjylland;2022-03-12;M;743;5;21;5572;2936853;45566
Nordjylland;2022-03-12;M;379;2;9;5574;2937232;45575
Sjælland;2022-03-12;M;353;4;29;5578;2937585;45604
Syddanmark;2022-03-12;M;739;5;19;5583;2938324;45623
Hovedstaden;2022-03-13;F;1088;2;28;5585;2939412;45651
Midtjylland;2022-03-13;F;1096;2;6;5587;2940508;45657
Nordjylland;2022-03-13;F;547;1;10;5588;2941055;45667
Sjælland;2022-03-13;F;477;3;11;5591;2941532;45678
Syddanmark;2022-03-13;F;1057;1;23;5592;2942589;45701
Hovedstaden;2022-03-13;M;940;5;31;5597;2943529;45732
Midtjylland;2022-03-13;M;929;1;20;5598;2944458;45752
Nordjylland;2022-03-13;M;436;1;13;5599;2944894;45765
Sjælland;2022-03-13;M;415;0;9;5599;2945309;45774
Syddanmark;2022-03-13;M;933;3;23;5602;2946242;45797
Hovedstaden;2022-03-14;F;1270;6;41;5608;2947512;45838
Midtjylland;2022-03-14;F;1379;5;25;5613;2948891;45863
Nordjylland;2022-03-14;F;628;2;13;5615;2949519;45876
Sjælland;2022-03-14;F;915;0;16;5615;2950434;45892
Syddanmark;2022-03-14;F;1321;1;26;5616;2951755;45918
Hovedstaden;2022-03-14;M;1091;4;29;5620;2952846;45947
Midtjylland;2022-03-14;M;1159;2;25;5622;2954005;45972
Nordjylland;2022-03-14;M;530;5;20;5627;2954535;45992
Sjælland;2022-03-14;M;679;2;23;5629;2955214;46015
Syddanmark;2022-03-14;M;1100;3;34;5632;2956314;46049
Hovedstaden;2022-03-15;F;1129;4;32;5636;2957443;46081
Midtjylland;2022-03-15;F;1232;1;23;5637;2958675;46104
Nordjylland;2022-03-15;F;580;3;13;5640;2959255;46117
Sjælland;2022-03-15;F;682;1;17;5641;2959937;46134
Syddanmark;2022-03-15;F;1210;3;21;5644;2961147;46155
Hovedstaden;2022-03-15;M;977;1;21;5645;2962124;46176
Midtjylland;2022-03-15;M;1053;1;18;5646;2963177;46194
Nordjylland;2022-03-15;M;444;5;17;5651;2963621;46211
Sjælland;2022-03-15;M;587;1;27;5652;2964208;46238
Syddanmark;2022-03-15;M;1047;2;25;5654;2965255;46263
Hovedstaden;2022-03-16;F;1099;2;26;5656;2966354;46289
Midtjylland;2022-03-16;F;1021;2;18;5658;2967375;46307
Nordjylland;2022-03-16;F;537;0;11;5658;2967912;46318
Sjælland;2022-03-16;F;633;1;12;5659;2968545;46330
Syddanmark;2022-03-16;F;1067;3;18;5662;2969612;46348
Hovedstaden;2022-03-16;M;880;2;20;5664;2970492;46368
Midtjylland;2022-03-16;M;943;8;18;5672;2971435;46386
Nordjylland;2022-03-16;M;439;2;14;5674;2971874;46400
Sjælland;2022-03-16;M;572;2;24;5676;2972446;46424
Syddanmark;2022-03-16;M;941;4;26;5680;2973387;46450
Hovedstaden;2022-03-17;F;964;3;28;5683;2974351;46478
Midtjylland;2022-03-17;F;952;0;21;5683;2975303;46499
Nordjylland;2022-03-17;F;512;3;11;5686;2975815;46510
Sjælland;2022-03-17;F;594;8;21;5694;2976409;46531
Syddanmark;2022-03-17;F;1022;2;25;5696;2977431;46556
Hovedstaden;2022-03-17;M;823;3;25;5699;2978254;46581
Midtjylland;2022-03-17;M;846;4;16;5703;2979100;46597
Nordjylland;2022-03-17;M;374;0;11;5703;2979474;46608
Sjælland;2022-03-17;M;507;2;18;5705;2979981;46626
Syddanmark;2022-03-17;M;816;6;25;5711;2980797;46651
Hovedstaden;2022-03-18;F;756;1;29;5712;2981553;46680
Midtjylland;2022-03-18;F;796;1;17;5713;2982349;46697
Nordjylland;2022-03-18;F;413;0;6;5713;2982762;46703
Sjælland;2022-03-18;F;495;1;18;5714;2983257;46721
Syddanmark;2022-03-18;F;821;0;17;5714;2984078;46738
Hovedstaden;2022-03-18;M;656;4;26;5718;2984734;46764
Midtjylland;2022-03-18;M;704;3;18;5721;2985438;46782
Nordjylland;2022-03-18;M;328;0;9;5721;2985766;46791
Sjælland;2022-03-18;M;393;1;10;5722;2986159;46801
Syddanmark;2022-03-18;M;687;4;27;5726;2986846;46828
Hovedstaden;2022-03-19;F;641;0;18;5726;2987487;46846
Midtjylland;2022-03-19;F;583;1;14;5727;2988070;46860
Nordjylland;2022-03-19;F;306;0;6;5727;2988376;46866
Sjælland;2022-03-19;F;340;1;10;5728;2988716;46876
Syddanmark;2022-03-19;F;624;2;22;5730;2989340;46898
Hovedstaden;2022-03-19;M;545;3;19;5733;2989885;46917
Midtjylland;2022-03-19;M;541;2;15;5735;2990426;46932
Nordjylland;2022-03-19;M;239;2;18;5737;2990665;46950
Sjælland;2022-03-19;M;311;0;17;5737;2990976;46967
Syddanmark;2022-03-19;M;531;4;18;5741;2991507;46985
Hovedstaden;2022-03-20;F;843;2;25;5743;2992350;47010
Midtjylland;2022-03-20;F;750;0;8;5743;2993100;47018
Nordjylland;2022-03-20;F;307;1;10;5744;2993407;47028
Sjælland;2022-03-20;F;419;0;17;5744;2993826;47045
Syddanmark;2022-03-20;F;701;0;14;5744;2994527;47059
Hovedstaden;2022-03-20;M;699;0;21;5744;2995226;47080
Midtjylland;2022-03-20;M;597;2;14;5746;2995823;47094
Nordjylland;2022-03-20;M;297;3;10;5749;2996120;47104
Sjælland;2022-03-20;M;307;1;10;5750;2996427;47114
Syddanmark;2022-03-20;M;618;1;25;5751;2997045;47139
Hovedstaden;2022-03-21;F;983;0;28;5751;2998028;47167
Midtjylland;2022-03-21;F;918;1;15;5752;2998946;47182
Nordjylland;2022-03-21;F;441;0;9;5752;2999387;47191
Sjælland;2022-03-21;F;702;2;20;5754;3000089;47211
Syddanmark;2022-03-21;F;1091;2;18;5756;3001180;47229
Hovedstaden;2022-03-21;M;804;6;31;5762;3001984;47260
Midtjylland;2022-03-21;M;743;4;18;5766;3002727;47278
Nordjylland;2022-03-21;M;385;1;11;5767;3003112;47289
Sjælland;2022-03-21;M;579;1;18;5768;3003691;47307
Syddanmark;2022-03-21;M;850;4;24;5772;3004541;47331
Hovedstaden;2022-03-22;F;935;1;29;5773;3005476;47360
Midtjylland;2022-03-22;F;759;0;9;5773;3006235;47369
Nordjylland;2022-03-22;F;330;0;10;5773;3006565;47379
Sjælland;2022-03-22;F;496;2;18;5775;3007061;47397
Syddanmark;2022-03-22;F;835;0;17;5775;3007896;47414
Hovedstaden;2022-03-22;M;704;4;26;5779;3008600;47440
Midtjylland;2022-03-22;M;707;4;23;5783;3009307;47463
Nordjylland;2022-03-22;M;285;4;15;5787;3009592;47478
Sjælland;2022-03-22;M;444;1;11;5788;3010036;47489
Syddanmark;2022-03-22;M;759;7;35;5795;3010795;47524
Hovedstaden;2022-03-23;F;793;0;24;5795;3011588;47548
Midtjylland;2022-03-23;F;729;1;21;5796;3012317;47569
Nordjylland;2022-03-23;F;340;3;17;5799;3012657;47586
Sjælland;2022-03-23;F;502;4;23;5803;3013159;47609
Syddanmark;2022-03-23;F;807;4;23;5807;3013966;47632
Hovedstaden;2022-03-23;M;666;3;30;5810;3014632;47662
Midtjylland;2022-03-23;M;615;0;22;5810;3015247;47684
Nordjylland;2022-03-23;M;284;2;14;5812;3015531;47698
Sjælland;2022-03-23;M;430;0;18;5812;3015961;47716
Syddanmark;2022-03-23;M;612;1;22;5813;3016573;47738
Hovedstaden;2022-03-24;F;735;3;21;5816;3017308;47759
Midtjylland;2022-03-24;F;596;1;7;5817;3017904;47766
Nordjylland;2022-03-24;F;292;1;6;5818;3018196;47772
Sjælland;2022-03-24;F;424;3;14;5821;3018620;47786
Syddanmark;2022-03-24;F;658;1;13;5822;3019278;47799
Hovedstaden;2022-03-24;M;584;5;17;5827;3019862;47816
Midtjylland;2022-03-24;M;519;0;12;5827;3020381;47828
Nordjylland;2022-03-24;M;242;0;8;5827;3020623;47836
Sjælland;2022-03-24;M;351;1;10;5828;3020974;47846
Syddanmark;2022-03-24;M;600;2;17;5830;3021574;47863
Hovedstaden;2022-03-25;F;601;3;23;5833;3022175;47886
Midtjylland;2022-03-25;F;509;1;13;5834;3022684;47899
Nordjylland;2022-03-25;F;266;0;6;5834;3022950;47905
Sjælland;2022-03-25;F;346;2;14;5836;3023296;47919
Syddanmark;2022-03-25;F;569;2;15;5838;3023865;47934
Hovedstaden;2022-03-25;M;473;2;17;5840;3024338;47951
Midtjylland;2022-03-25;M;482;4;23;5844;3024820;47974
Nordjylland;2022-03-25;M;212;1;9;5845;3025032;47983
Sjælland;2022-03-25;M;271;0;10;5845;3025303;47993
Syddanmark;2022-03-25;M;514;4;29;5849;3025817;48022
Hovedstaden;2022-03-26;F;445;1;15;5850;3026262;48037
Midtjylland;2022-03-26;F;390;2;11;5852;3026652;48048
Nordjylland;2022-03-26;F;199;0;5;5852;3026851;48053
Sjælland;2022-03-26;F;203;0;5;5852;3027054;48058
Syddanmark;2022-03-26;F;373;2;8;5854;3027427;48066
Hovedstaden;2022-03-26;M;400;2;17;5856;3027827;48083
Midtjylland;2022-03-26;M;350;1;9;5857;3028177;48092
Nordjylland;2022-03-26;M;166;0;2;5857;3028343;48094
Sjælland;2022-03-26;M;174;1;10;5858;3028517;48104
Syddanmark;2022-03-26;M;318;0;13;5858;3028835;48117
Hovedstaden;2022-03-27;F;538;3;17;5861;3029373;48134
Midtjylland;2022-03-27;F;456;1;7;5862;3029829;48141
Nordjylland;2022-03-27;F;188;0;4;5862;3030017;48145
Sjælland;2022-03-27;F;212;0;9;5862;3030229;48154
Syddanmark;2022-03-27;F;438;3;8;5865;3030667;48162
Hovedstaden;2022-03-27;M;443;0;21;5865;3031110;48183
Midtjylland;2022-03-27;M;415;1;15;5866;3031525;48198
Nordjylland;2022-03-27;M;158;0;5;5866;3031683;48203
Sjælland;2022-03-27;M;193;0;13;5866;3031876;48216
Syddanmark;2022-03-27;M;382;2;14;5868;3032258;48230
Hovedstaden;2022-03-28;F;724;3;22;5871;3032982;48252
Midtjylland;2022-03-28;F;529;1;19;5872;3033511;48271
Nordjylland;2022-03-28;F;278;1;6;5873;3033789;48277
Sjælland;2022-03-28;F;472;1;12;5874;3034261;48289
Syddanmark;2022-03-28;F;669;3;19;5877;3034930;48308
Hovedstaden;2022-03-28;M;591;3;24;5880;3035521;48332
Midtjylland;2022-03-28;M;470;0;14;5880;3035991;48346
Nordjylland;2022-03-28;M;251;0;7;5880;3036242;48353
Sjælland;2022-03-28;M;385;2;14;5882;3036627;48367
Syddanmark;2022-03-28;M;593;3;22;5885;3037220;48389
Hovedstaden;2022-03-29;F;621;1;26;5886;3037841;48415
Midtjylland;2022-03-29;F;507;0;7;5886;3038348;48422
Nordjylland;2022-03-29;F;236;0;8;5886;3038584;48430
Sjælland;2022-03-29;F;340;0;13;5886;3038924;48443
Syddanmark;2022-03-29;F;546;2;17;5888;3039470;48460
Hovedstaden;2022-03-29;M;504;4;14;5892;3039974;48474
Midtjylland;2022-03-29;M;405;1;15;5893;3040379;48489
Nordjylland;2022-03-29;M;178;2;9;5895;3040557;48498
Sjælland;2022-03-29;M;288;5;18;5900;3040845;48516
Syddanmark;2022-03-29;M;451;3;13;5903;3041296;48529
Hovedstaden;2022-03-30;F;549;3;21;5906;3041845;48550
Midtjylland;2022-03-30;F;440;1;11;5907;3042285;48561
Nordjylland;2022-03-30;F;212;0;6;5907;3042497;48567
Sjælland;2022-03-30;F;344;0;10;5907;3042841;48577
Syddanmark;2022-03-30;F;449;3;19;5910;3043290;48596
Hovedstaden;2022-03-30;M;474;1;15;5911;3043764;48611
Midtjylland;2022-03-30;M;370;1;10;5912;3044134;48621
Nordjylland;2022-03-30;M;171;0;7;5912;3044305;48628
Sjælland;2022-03-30;M;309;1;16;5913;3044614;48644
Syddanmark;2022-03-30;M;426;2;16;5915;3045040;48660
Hovedstaden;2022-03-31;F;447;2;21;5917;3045487;48681
Midtjylland;2022-03-31;F;367;2;17;5919;3045854;48698
Nordjylland;2022-03-31;F;161;1;7;5920;3046015;48705
Sjælland;2022-03-31;F;267;0;15;5920;3046282;48720
Syddanmark;2022-03-31;F;424;0;11;5920;3046706;48731
Hovedstaden;2022-03-31;M;361;3;15;5923;3047067;48746
Midtjylland;2022-03-31;M;321;3;14;5926;3047388;48760
Nordjylland;2022-03-31;M;142;2;5;5928;3047530;48765
Sjælland;2022-03-31;M;210;0;9;5928;3047740;48774
Syddanmark;2022-03-31;M;333;4;13;5932;3048073;48787
Hovedstaden;2022-04-01;F;415;1;25;5933;3048488;48812
Midtjylland;2022-04-01;F;285;0;8;5933;3048773;48820
Nordjylland;2022-04-01;F;155;1;6;5934;3048928;48826
Sjælland;2022-04-01;F;220;0;11;5934;3049148;48837
Syddanmark;2022-04-01;F;364;3;11;5937;3049512;48848
Hovedstaden;2022-04-01;M;301;1;15;5938;3049813;48863
Midtjylland;2022-04-01;M;233;0;7;5938;3050046;48870
Nordjylland;2022-04-01;M;126;2;9;5940;3050172;48879
Sjælland;2022-04-01;M;181;0;7;5940;3050353;48886
Syddanmark;2022-04-01;M;321;0;18;5940;3050674;48904
Hovedstaden;2022-04-02;F;318;0;20;5940;3050992;48924
Midtjylland;2022-04-02;F;224;0;5;5940;3051216;48929
Nordjylland;2022-04-02;F;106;0;6;5940;3051322;48935
Sjælland;2022-04-02;F;155;3;12;5943;3051477;48947
Syddanmark;2022-04-02;F;282;2;11;5945;3051759;48958
Hovedstaden;2022-04-02;M;271;0;11;5945;3052030;48969
Midtjylland;2022-04-02;M;211;0;4;5945;3052241;48973
Nordjylland;2022-04-02;M;99;1;7;5946;3052340;48980
Sjælland;2022-04-02;M;147;0;10;5946;3052487;48990
Syddanmark;2022-04-02;M;220;0;7;5946;3052707;48997
Hovedstaden;2022-04-03;F;350;0;17;5946;3053057;49014
Midtjylland;2022-04-03;F;269;0;10;5946;3053326;49024
Nordjylland;2022-04-03;F;109;0;0;5946;3053435;49024
Sjælland;2022-04-03;F;177;2;9;5948;3053612;49033
Syddanmark;2022-04-03;F;304;3;12;5951;3053916;49045
Hovedstaden;2022-04-03;M;323;0;9;5951;3054239;49054
Midtjylland;2022-04-03;M;229;0;6;5951;3054468;49060
Nordjylland;2022-04-03;M;128;2;10;5953;3054596;49070
Sjælland;2022-04-03;M;155;2;10;5955;3054751;49080
Syddanmark;2022-04-03;M;258;4;16;5959;3055009;49096
Hovedstaden;2022-04-04;F;488;8;20;5967;3055497;49116
Midtjylland;2022-04-04;F;411;1;10;5968;3055908;49126
Nordjylland;2022-04-04;F;160;0;3;5968;3056068;49129
Sjælland;2022-04-04;F;372;3;13;5971;3056440;49142
Syddanmark;2022-04-04;F;437;2;13;5973;3056877;49155
Hovedstaden;2022-04-04;M;429;5;25;5978;3057306;49180
Midtjylland;2022-04-04;M;321;2;14;5980;3057627;49194
Nordjylland;2022-04-04;M;160;0;9;5980;3057787;49203
Sjælland;2022-04-04;M;291;1;14;5981;3058078;49217
Syddanmark;2022-04-04;M;359;4;19;5985;3058437;49236
Hovedstaden;2022-04-05;F;466;3;28;5988;3058903;49264
Midtjylland;2022-04-05;F;333;0;8;5988;3059236;49272
Nordjylland;2022-04-05;F;192;5;6;5993;3059428;49278
Sjælland;2022-04-05;F;298;1;14;5994;3059726;49292
Syddanmark;2022-04-05;F;375;1;6;5995;3060101;49298
Hovedstaden;2022-04-05;M;412;1;22;5996;3060513;49320
Midtjylland;2022-04-05;M;300;1;9;5997;3060813;49329
Nordjylland;2022-04-05;M;160;3;6;6000;3060973;49335
Sjælland;2022-04-05;M;224;2;13;6002;3061197;49348
Syddanmark;2022-04-05;M;314;2;13;6004;3061511;49361
Hovedstaden;2022-04-06;F;402;2;15;6006;3061913;49376
Midtjylland;2022-04-06;F;307;1;10;6007;3062220;49386
Nordjylland;2022-04-06;F;146;0;3;6007;3062366;49389
Sjælland;2022-04-06;F;256;2;13;6009;3062622;49402
Syddanmark;2022-04-06;F;369;1;10;6010;3062991;49412
Hovedstaden;2022-04-06;M;356;2;22;6012;3063347;49434
Midtjylland;2022-04-06;M;261;2;7;6014;3063608;49441
Nordjylland;2022-04-06;M;118;2;6;6016;3063726;49447
Sjælland;2022-04-06;M;214;0;11;6016;3063940;49458
Syddanmark;2022-04-06;M;323;4;13;6020;3064263;49471
Hovedstaden;2022-04-07;F;434;1;14;6021;3064697;49485
Midtjylland;2022-04-07;F;305;0;6;6021;3065002;49491
Nordjylland;2022-04-07;F;148;1;7;6022;3065150;49498
Sjælland;2022-04-07;F;269;2;11;6024;3065419;49509
Syddanmark;2022-04-07;F;360;2;8;6026;3065779;49517
Hovedstaden;2022-04-07;M;369;4;21;6030;3066148;49538
Midtjylland;2022-04-07;M;252;0;12;6030;3066400;49550
Nordjylland;2022-04-07;M;116;0;6;6030;3066516;49556
Sjælland;2022-04-07;M;175;2;8;6032;3066691;49564
Syddanmark;2022-04-07;M;278;7;20;6039;3066969;49584
Hovedstaden;2022-04-08;F;334;1;9;6040;3067303;49593
Midtjylland;2022-04-08;F;255;1;10;6041;3067558;49603
Nordjylland;2022-04-08;F;124;1;9;6042;3067682;49612
Sjælland;2022-04-08;F;220;0;9;6042;3067902;49621
Syddanmark;2022-04-08;F;303;2;15;6044;3068205;49636
Hovedstaden;2022-04-08;M;274;1;18;6045;3068479;49654
Midtjylland;2022-04-08;M;202;0;7;6045;3068681;49661
Nordjylland;2022-04-08;M;105;0;6;6045;3068786;49667
Sjælland;2022-04-08;M;186;0;11;6045;3068972;49678
Syddanmark;2022-04-08;M;226;1;20;6046;3069198;49698
Hovedstaden;2022-04-09;F;275;0;10;6046;3069473;49708
Midtjylland;2022-04-09;F;201;4;7;6050;3069674;49715
Nordjylland;2022-04-09;F;108;0;7;6050;3069782;49722
Sjælland;2022-04-09;F;120;0;9;6050;3069902;49731
Syddanmark;2022-04-09;F;216;3;14;6053;3070118;49745
Hovedstaden;2022-04-09;M;237;0;7;6053;3070355;49752
Midtjylland;2022-04-09;M;178;0;14;6053;3070533;49766
Nordjylland;2022-04-09;M;84;0;7;6053;3070617;49773
Sjælland;2022-04-09;M;126;0;11;6053;3070743;49784
Syddanmark;2022-04-09;M;183;1;7;6054;3070926;49791
Hovedstaden;2022-04-10;F;367;2;22;6056;3071293;49813
Midtjylland;2022-04-10;F;216;1;8;6057;3071509;49821
Nordjylland;2022-04-10;F;88;0;2;6057;3071597;49823
Sjælland;2022-04-10;F;130;0;8;6057;3071727;49831
Syddanmark;2022-04-10;F;224;2;7;6059;3071951;49838
Hovedstaden;2022-04-10;M;239;1;12;6060;3072190;49850
Midtjylland;2022-04-10;M;179;1;6;6061;3072369;49856
Nordjylland;2022-04-10;M;71;0;1;6061;3072440;49857
Sjælland;2022-04-10;M;137;1;14;6062;3072577;49871
Syddanmark;2022-04-10;M;182;0;9;6062;3072759;49880
Hovedstaden;2022-04-11;F;387;1;20;6063;3073146;49900
Midtjylland;2022-04-11;F;320;1;13;6064;3073466;49913
Nordjylland;2022-04-11;F;157;1;4;6065;3073623;49917
Sjælland;2022-04-11;F;275;0;12;6065;3073898;49929
Syddanmark;2022-04-11;F;304;2;5;6067;3074202;49934
Hovedstaden;2022-04-11;M;289;2;20;6069;3074491;49954
Midtjylland;2022-04-11;M;274;2;11;6071;3074765;49965
Nordjylland;2022-04-11;M;124;1;6;6072;3074889;49971
Sjælland;2022-04-11;M;202;2;16;6074;3075091;49987
Syddanmark;2022-04-11;M;255;3;13;6077;3075346;50000
Hovedstaden;2022-04-12;F;356;0;12;6077;3075702;50012
Midtjylland;2022-04-12;F;253;0;10;6077;3075955;50022
Nordjylland;2022-04-12;F;115;0;6;6077;3076070;50028
Sjælland;2022-04-12;F;218;1;12;6078;3076288;50040
Syddanmark;2022-04-12;F;274;2;7;6080;3076562;50047
Hovedstaden;2022-04-12;M;306;1;21;6081;3076868;50068
Midtjylland;2022-04-12;M;219;0;10;6081;3077087;50078
Nordjylland;2022-04-12;M;103;0;5;6081;3077190;50083
Sjælland;2022-04-12;M;180;1;9;6082;3077370;50092
Syddanmark;2022-04-12;M;241;0;12;6082;3077611;50104
Hovedstaden;2022-04-13;F;355;3;18;6085;3077966;50122
Midtjylland;2022-04-13;F;227;0;10;6085;3078193;50132
Nordjylland;2022-04-13;F;107;1;5;6086;3078300;50137
Sjælland;2022-04-13;F;222;0;12;6086;3078522;50149
Syddanmark;2022-04-13;F;266;0;9;6086;3078788;50158
Hovedstaden;2022-04-13;M;304;1;24;6087;3079092;50182
Midtjylland;2022-04-13;M;200;0;6;6087;3079292;50188
Nordjylland;2022-04-13;M;85;2;3;6089;3079377;50191
Sjælland;2022-04-13;M;188;1;17;6090;3079565;50208
Syddanmark;2022-04-13;M;222;0;7;6090;3079787;50215
Hovedstaden;2022-04-14;F;217;1;13;6091;3080004;50228
Midtjylland;2022-04-14;F;141;0;8;6091;3080145;50236
Nordjylland;2022-04-14;F;120;0;3;6091;3080265;50239
Sjælland;2022-04-14;F;77;1;9;6092;3080342;50248
Syddanmark;2022-04-14;F;196;2;12;6094;3080538;50260
Hovedstaden;2022-04-14;M;179;0;9;6094;3080717;50269
Midtjylland;2022-04-14;M;138;1;9;6095;3080855;50278
Nordjylland;2022-04-14;M;80;0;7;6095;3080935;50285
Sjælland;2022-04-14;M;78;1;9;6096;3081013;50294
Syddanmark;2022-04-14;M;177;0;8;6096;3081190;50302
Hovedstaden;2022-04-15;F;205;0;9;6096;3081395;50311
Midtjylland;2022-04-15;F;173;0;9;6096;3081568;50320
Nordjylland;2022-04-15;F;63;0;3;6096;3081631;50323
Sjælland;2022-04-15;F;146;1;11;6097;3081777;50334
Syddanmark;2022-04-15;F;193;2;4;6099;3081970;50338
Hovedstaden;2022-04-15;M;191;0;16;6099;3082161;50354
Midtjylland;2022-04-15;M;140;1;6;6100;3082301;50360
Nordjylland;2022-04-15;M;51;1;6;6101;3082352;50366
Sjælland;2022-04-15;M;115;2;7;6103;3082467;50373
Syddanmark;2022-04-15;M;164;1;11;6104;3082631;50384
Hovedstaden;2022-04-16;F;276;1;17;6105;3082907;50401
Midtjylland;2022-04-16;F;170;0;3;6105;3083077;50404
Nordjylland;2022-04-16;F;100;1;5;6106;3083177;50409
Sjælland;2022-04-16;F;166;1;5;6107;3083343;50414
Syddanmark;2022-04-16;F;153;5;7;6112;3083496;50421
Hovedstaden;2022-04-16;M;245;1;8;6113;3083741;50429
Midtjylland;2022-04-16;M;128;0;5;6113;3083869;50434
Nordjylland;2022-04-16;M;72;0;2;6113;3083941;50436
Sjælland;2022-04-16;M;129;1;15;6114;3084070;50451
Syddanmark;2022-04-16;M;124;2;6;6116;3084194;50457
Hovedstaden;2022-04-17;F;193;1;13;6117;3084387;50470
Midtjylland;2022-04-17;F;159;0;9;6117;3084546;50479
Nordjylland;2022-04-17;F;55;0;7;6117;3084601;50486
Sjælland;2022-04-17;F;78;1;8;6118;3084679;50494
Syddanmark;2022-04-17;F;173;2;6;6120;3084852;50500
Hovedstaden;2022-04-17;M;152;2;19;6122;3085004;50519
Midtjylland;2022-04-17;M;149;1;8;6123;3085153;50527
Nordjylland;2022-04-17;M;62;0;4;6123;3085215;50531
Sjælland;2022-04-17;M;68;2;13;6125;3085283;50544
Syddanmark;2022-04-17;M;163;1;12;6126;3085446;50556
Hovedstaden;2022-04-18;F;283;3;19;6129;3085729;50575
Midtjylland;2022-04-18;F;215;3;9;6132;3085944;50584
Nordjylland;2022-04-18;F;155;1;4;6133;3086099;50588
Sjælland;2022-04-18;F;119;0;8;6133;3086218;50596
Syddanmark;2022-04-18;F;188;0;11;6133;3086406;50607
Hovedstaden;2022-04-18;M;223;2;18;6135;3086629;50625
Midtjylland;2022-04-18;M;175;0;5;6135;3086804;50630
Nordjylland;2022-04-18;M;102;1;5;6136;3086906;50635
Sjælland;2022-04-18;M;99;1;4;6137;3087005;50639
Syddanmark;2022-04-18;M;179;1;7;6138;3087184;50646
Hovedstaden;2022-04-19;F;396;1;15;6139;3087580;50661
Midtjylland;2022-04-19;F;239;0;5;6139;3087819;50666
Nordjylland;2022-04-19;F;161;0;3;6139;3087980;50669
Sjælland;2022-04-19;F;289;2;12;6141;3088269;50681
Syddanmark;2022-04-19;F;250;1;12;6142;3088519;50693
Hovedstaden;2022-04-19;M;328;1;20;6143;3088847;50713
Midtjylland;2022-04-19;M;203;1;6;6144;3089050;50719
Nordjylland;2022-04-19;M;122;0;9;6144;3089172;50728
Sjælland;2022-04-19;M;250;1;8;6145;3089422;50736
Syddanmark;2022-04-19;M;206;2;12;6147;3089628;50748
Hovedstaden;2022-04-20;F;302;1;16;6148;3089930;50764
Midtjylland;2022-04-20;F;238;0;4;6148;3090168;50768
Nordjylland;2022-04-20;F;135;0;6;6148;3090303;50774
Sjælland;2022-04-20;F;183;0;2;6148;3090486;50776
Syddanmark;2022-04-20;F;189;4;9;6152;3090675;50785
Hovedstaden;2022-04-20;M;263;2;13;6154;3090938;50798
Midtjylland;2022-04-20;M;191;2;10;6156;3091129;50808
Nordjylland;2022-04-20;M;122;1;5;6157;3091251;50813
Sjælland;2022-04-20;M;138;1;7;6158;3091389;50820
Syddanmark;2022-04-20;M;179;1;12;6159;3091568;50832
Hovedstaden;2022-04-21;F;278;3;13;6162;3091846;50845
Midtjylland;2022-04-21;F;195;0;15;6162;3092041;50860
Nordjylland;2022-04-21;F;113;0;3;6162;3092154;50863
Sjælland;2022-04-21;F;129;0;5;6162;3092283;50868
Syddanmark;2022-04-21;F;184;1;9;6163;3092467;50877
Hovedstaden;2022-04-21;M;236;5;18;6168;3092703;50895
Midtjylland;2022-04-21;M;173;0;7;6168;3092876;50902
Nordjylland;2022-04-21;M;90;2;6;6170;3092966;50908
Sjælland;2022-04-21;M;127;0;11;6170;3093093;50919
Syddanmark;2022-04-21;M;153;3;4;6173;3093246;50923
Hovedstaden;2022-04-22;F;212;2;14;6175;3093458;50937
Midtjylland;2022-04-22;F;133;0;6;6175;3093591;50943
Nordjylland;2022-04-22;F;78;1;7;6176;3093669;50950
Sjælland;2022-04-22;F;105;1;10;6177;3093774;50960
Syddanmark;2022-04-22;F;157;0;8;6177;3093931;50968
Hovedstaden;2022-04-22;M;165;1;13;6178;3094096;50981
Midtjylland;2022-04-22;M;129;1;8;6179;3094225;50989
Nordjylland;2022-04-22;M;73;4;7;6183;3094298;50996
Sjælland;2022-04-22;M;93;0;5;6183;3094391;51001
Syddanmark;2022-04-22;M;115;1;5;6184;3094506;51006
Hovedstaden;2022-04-23;F;166;1;22;6185;3094672;51028
Midtjylland;2022-04-23;F;110;1;7;6186;3094782;51035
Nordjylland;2022-04-23;F;58;0;0;6186;3094840;51035
Sjælland;2022-04-23;F;66;0;3;6186;3094906;51038
Syddanmark;2022-04-23;F;140;2;6;6188;3095046;51044
Hovedstaden;2022-04-23;M;117;4;8;6192;3095163;51052
Midtjylland;2022-04-23;M;97;0;2;6192;3095260;51054
Nordjylland;2022-04-23;M;54;1;2;6193;3095314;51056
Sjælland;2022-04-23;M;57;2;6;6195;3095371;51062
Syddanmark;2022-04-23;M;110;0;8;6195;3095481;51070
Hovedstaden;2022-04-24;F;188;1;9;6196;3095669;51079
Midtjylland;2022-04-24;F;119;0;5;6196;3095788;51084
Nordjylland;2022-04-24;F;62;1;6;6197;3095850;51090
Sjælland;2022-04-24;F;87;1;7;6198;3095937;51097
Syddanmark;2022-04-24;F;109;2;6;6200;3096046;51103
Hovedstaden;2022-04-24;M;141;2;13;6202;3096187;51116
Midtjylland;2022-04-24;M;87;0;3;6202;3096274;51119
Nordjylland;2022-04-24;M;43;2;5;6204;3096317;51124
Sjælland;2022-04-24;M;73;2;9;6206;3096390;51133
Syddanmark;2022-04-24;M;88;2;6;6208;3096478;51139
Hovedstaden;2022-04-25;F;272;1;19;6209;3096750;51158
Midtjylland;2022-04-25;F;153;1;9;6210;3096903;51167
Nordjylland;2022-04-25;F;88;0;7;6210;3096991;51174
Sjælland;2022-04-25;F;138;3;9;6213;3097129;51183
Syddanmark;2022-04-25;F;161;0;6;6213;3097290;51189
Hovedstaden;2022-04-25;M;178;2;15;6215;3097468;51204
Midtjylland;2022-04-25;M;157;1;9;6216;3097625;51213
Nordjylland;2022-04-25;M;77;0;0;6216;3097702;51213
Sjælland;2022-04-25;M;126;1;9;6217;3097828;51222
Syddanmark;2022-04-25;M;148;1;5;6218;3097976;51227
Hovedstaden;2022-04-26;F;222;2;15;6220;3098198;51242
Midtjylland;2022-04-26;F;150;0;5;6220;3098348;51247
Nordjylland;2022-04-26;F;62;1;7;6221;3098410;51254
Sjælland;2022-04-26;F;94;0;11;6221;3098504;51265
Syddanmark;2022-04-26;F;138;0;9;6221;3098642;51274
Hovedstaden;2022-04-26;M;152;1;16;6222;3098794;51290
Midtjylland;2022-04-26;M;111;1;6;6223;3098905;51296
Nordjylland;2022-04-26;M;54;1;3;6224;3098959;51299
Sjælland;2022-04-26;M;82;0;6;6224;3099041;51305
Syddanmark;2022-04-26;M;110;2;7;6226;3099151;51312
Hovedstaden;2022-04-27;F;198;0;13;6226;3099349;51325
Midtjylland;2022-04-27;F;112;0;4;6226;3099461;51329
Nordjylland;2022-04-27;F;58;0;2;6226;3099519;51331
Sjælland;2022-04-27;F;107;0;6;6226;3099626;51337
Syddanmark;2022-04-27;F;101;0;3;6226;3099727;51340
Hovedstaden;2022-04-27;M;177;0;10;6226;3099904;51350
Midtjylland;2022-04-27;M;99;1;5;6227;3100003;51355
Nordjylland;2022-04-27;M;43;1;2;6228;3100046;51357
Sjælland;2022-04-27;M;79;0;5;6228;3100125;51362
Syddanmark;2022-04-27;M;106;1;4;6229;3100231;51366
Hovedstaden;2022-04-28;F;204;0;10;6229;3100435;51376
Midtjylland;2022-04-28;F;85;0;1;6229;3100520;51377
Nordjylland;2022-04-28;F;52;0;3;6229;3100572;51380
Sjælland;2022-04-28;F;95;1;8;6230;3100667;51388
Syddanmark;2022-04-28;F;104;1;6;6231;3100771;51394
Hovedstaden;2022-04-28;M;163;0;11;6231;3100934;51405
Midtjylland;2022-04-28;M;90;0;8;6231;3101024;51413
Nordjylland;2022-04-28;M;42;1;1;6232;3101066;51414
Sjælland;2022-04-28;M;64;1;4;6233;3101130;51418
Syddanmark;2022-04-28;M;83;0;8;6233;3101213;51426
Hovedstaden;2022-04-29;F;150;1;10;6234;3101363;51436
Midtjylland;2022-04-29;F;102;0;6;6234;3101465;51442
Nordjylland;2022-04-29;F;42;1;1;6235;3101507;51443
Sjælland;2022-04-29;F;66;1;7;6236;3101573;51450
Syddanmark;2022-04-29;F;93;1;6;6237;3101666;51456
Hovedstaden;2022-04-29;M;146;0;15;6237;3101812;51471
Midtjylland;2022-04-29;M;75;1;3;6238;3101887;51474
Nordjylland;2022-04-29;M;39;0;3;6238;3101926;51477
Sjælland;2022-04-29;M;60;1;6;6239;3101986;51483
Syddanmark;2022-04-29;M;75;1;7;6240;3102061;51490
Hovedstaden;2022-04-30;F;157;1;13;6241;3102218;51503
Midtjylland;2022-04-30;F;60;0;4;6241;3102278;51507
Nordjylland;2022-04-30;F;28;0;2;6241;3102306;51509
Sjælland;2022-04-30;F;42;0;3;6241;3102348;51512
Syddanmark;2022-04-30;F;84;1;6;6242;3102432;51518
Hovedstaden;2022-04-30;M;107;0;7;6242;3102539;51525
Midtjylland;2022-04-30;M;58;0;3;6242;3102597;51528
Nordjylland;2022-04-30;M;24;0;0;6242;3102621;51528
Sjælland;2022-04-30;M;35;0;7;6242;3102656;51535
Syddanmark;2022-04-30;M;68;0;1;6242;3102724;51536
Hovedstaden;2022-05-01;F;147;2;11;6244;3102871;51547
Midtjylland;2022-05-01;F;80;0;1;6244;3102951;51548
Nordjylland;2022-05-01;F;48;2;1;6246;3102999;51549
Sjælland;2022-05-01;F;81;0;8;6246;3103080;51557
Syddanmark;2022-05-01;F;87;1;6;6247;3103167;51563
Hovedstaden;2022-05-01;M;108;2;6;6249;3103275;51569
Midtjylland;2022-05-01;M;66;1;6;6250;3103341;51575
Nordjylland;2022-05-01;M;31;1;2;6251;3103372;51577
Sjælland;2022-05-01;M;68;1;3;6252;3103440;51580
Syddanmark;2022-05-01;M;57;0;3;6252;3103497;51583
Hovedstaden;2022-05-02;F;190;1;12;6253;3103687;51595
Midtjylland;2022-05-02;F;122;0;4;6253;3103809;51599
Nordjylland;2022-05-02;F;44;0;1;6253;3103853;51600
Sjælland;2022-05-02;F;85;2;2;6255;3103938;51602
Syddanmark;2022-05-02;F;131;0;5;6255;3104069;51607
Hovedstaden;2022-05-02;M;170;0;12;6255;3104239;51619
Midtjylland;2022-05-02;M;95;1;2;6256;3104334;51621
Nordjylland;2022-05-02;M;47;0;4;6256;3104381;51625
Sjælland;2022-05-02;M;70;1;7;6257;3104451;51632
Syddanmark;2022-05-02;M;87;0;4;6257;3104538;51636
Hovedstaden;2022-05-03;F;162;1;11;6258;3104700;51647
Midtjylland;2022-05-03;F;88;0;4;6258;3104788;51651
Nordjylland;2022-05-03;F;30;0;3;6258;3104818;51654
Sjælland;2022-05-03;F;86;0;6;6258;3104904;51660
Syddanmark;2022-05-03;F;111;0;1;6258;3105015;51661
Hovedstaden;2022-05-03;M;143;4;12;6262;3105158;51673
Midtjylland;2022-05-03;M;97;1;4;6263;3105255;51677
Nordjylland;2022-05-03;M;39;0;4;6263;3105294;51681
Sjælland;2022-05-03;M;91;0;6;6263;3105385;51687
Syddanmark;2022-05-03;M;84;2;5;6265;3105469;51692
Hovedstaden;2022-05-04;F;181;2;7;6267;3105650;51699
Midtjylland;2022-05-04;F;108;2;2;6269;3105758;51701
Nordjylland;2022-05-04;F;47;0;1;6269;3105805;51702
Sjælland;2022-05-04;F;76;0;6;6269;3105881;51708
Syddanmark;2022-05-04;F;107;0;1;6269;3105988;51709
Hovedstaden;2022-05-04;M;114;0;10;6269;3106102;51719
Midtjylland;2022-05-04;M;97;1;5;6270;3106199;51724
Nordjylland;2022-05-04;M;41;0;4;6270;3106240;51728
Sjælland;2022-05-04;M;41;0;2;6270;3106281;51730
Syddanmark;2022-05-04;M;94;2;10;6272;3106375;51740
Hovedstaden;2022-05-05;F;197;3;12;6275;3106572;51752
Midtjylland;2022-05-05;F;81;0;1;6275;3106653;51753
Nordjylland;2022-05-05;F;53;2;6;6277;3106706;51759
Sjælland;2022-05-05;F;77;0;2;6277;3106783;51761
Syddanmark;2022-05-05;F;99;1;3;6278;3106882;51764
Hovedstaden;2022-05-05;M;163;0;13;6278;3107045;51777
Midtjylland;2022-05-05;M;100;0;5;6278;3107145;51782
Nordjylland;2022-05-05;M;31;0;1;6278;3107176;51783
Sjælland;2022-05-05;M;89;2;4;6280;3107265;51787
Syddanmark;2022-05-05;M;80;3;6;6283;3107345;51793
Hovedstaden;2022-05-06;F;143;1;8;6284;3107488;51801
Midtjylland;2022-05-06;F;94;0;5;6284;3107582;51806
Nordjylland;2022-05-06;F;35;0;4;6284;3107617;51810
Sjælland;2022-05-06;F;62;0;0;6284;3107679;51810
Syddanmark;2022-05-06;F;73;0;5;6284;3107752;51815
Hovedstaden;2022-05-06;M;112;0;7;6284;3107864;51822
Midtjylland;2022-05-06;M;75;0;4;6284;3107939;51826
Nordjylland;2022-05-06;M;29;0;4;6284;3107968;51830
Sjælland;2022-05-06;M;53;0;2;6284;3108021;51832
Syddanmark;2022-05-06;M;73;0;7;6284;3108094;51839
Hovedstaden;2022-05-07;F;125;1;9;6285;3108219;51848
Midtjylland;2022-05-07;F;53;0;1;6285;3108272;51849
Nordjylland;2022-05-07;F;27;0;1;6285;3108299;51850
Sjælland;2022-05-07;F;42;1;5;6286;3108341;51855
Syddanmark;2022-05-07;F;63;0;1;6286;3108404;51856
Hovedstaden;2022-05-07;M;88;0;3;6286;3108492;51859
Midtjylland;2022-05-07;M;47;1;5;6287;3108539;51864
Nordjylland;2022-05-07;M;20;0;3;6287;3108559;51867
Sjælland;2022-05-07;M;41;1;6;6288;3108600;51873
Syddanmark;2022-05-07;M;68;1;4;6289;3108668;51877
Hovedstaden;2022-05-08;F;106;0;5;6289;3108774;51882
Midtjylland;2022-05-08;F;66;0;1;6289;3108840;51883
Nordjylland;2022-05-08;F;44;1;3;6290;3108884;51886
Sjælland;2022-05-08;F;44;0;2;6290;3108928;51888
Syddanmark;2022-05-08;F;60;0;4;6290;3108988;51892
Hovedstaden;2022-05-08;M;109;2;10;6292;3109097;51902
Midtjylland;2022-05-08;M;52;0;2;6292;3109149;51904
Nordjylland;2022-05-08;M;32;0;2;6292;3109181;51906
Sjælland;2022-05-08;M;47;3;9;6295;3109228;51915
Syddanmark;2022-05-08;M;60;0;7;6295;3109288;51922
Hovedstaden;2022-05-09;F;187;0;13;6295;3109475;51935
Midtjylland;2022-05-09;F;95;0;4;6295;3109570;51939
Nordjylland;2022-05-09;F;44;1;2;6296;3109614;51941
Sjælland;2022-05-09;F;70;0;1;6296;3109684;51942
Syddanmark;2022-05-09;F;113;1;5;6297;3109797;51947
Hovedstaden;2022-05-09;M;125;0;5;6297;3109922;51952
Midtjylland;2022-05-09;M;98;0;3;6297;3110020;51955
Nordjylland;2022-05-09;M;48;0;2;6297;3110068;51957
Sjælland;2022-05-09;M;51;0;6;6297;3110119;51963
Syddanmark;2022-05-09;M;97;2;7;6299;3110216;51970
Hovedstaden;2022-05-10;F;156;1;9;6300;3110372;51979
Midtjylland;2022-05-10;F;91;0;2;6300;3110463;51981
Nordjylland;2022-05-10;F;38;0;3;6300;3110501;51984
Sjælland;2022-05-10;F;84;1;5;6301;3110585;51989
Syddanmark;2022-05-10;F;101;0;1;6301;3110686;51990
Hovedstaden;2022-05-10;M;127;2;8;6303;3110813;51998
Midtjylland;2022-05-10;M;69;0;4;6303;3110882;52002
Nordjylland;2022-05-10;M;42;0;3;6303;3110924;52005
Sjælland;2022-05-10;M;53;1;5;6304;3110977;52010
Syddanmark;2022-05-10;M;76;2;4;6306;3111053;52014
Hovedstaden;2022-05-11;F;135;0;7;6306;3111188;52021
Midtjylland;2022-05-11;F;78;0;1;6306;3111266;52022
Nordjylland;2022-05-11;F;38;1;2;6307;3111304;52024
Sjælland;2022-05-11;F;59;0;3;6307;3111363;52027
Syddanmark;2022-05-11;F;94;0;6;6307;3111457;52033
Hovedstaden;2022-05-11;M;105;1;4;6308;3111562;52037
Midtjylland;2022-05-11;M;79;1;3;6309;3111641;52040
Nordjylland;2022-05-11;M;26;0;3;6309;3111667;52043
Sjælland;2022-05-11;M;64;0;0;6309;3111731;52043
Syddanmark;2022-05-11;M;77;0;5;6309;3111808;52048
Hovedstaden;2022-05-12;F;181;0;10;6309;3111989;52058
Midtjylland;2022-05-12;F;68;0;2;6309;3112057;52060
Nordjylland;2022-05-12;F;28;0;2;6309;3112085;52062
Sjælland;2022-05-12;F;56;0;2;6309;3112141;52064
Syddanmark;2022-05-12;F;68;1;4;6310;3112209;52068
Hovedstaden;2022-05-12;M;113;0;6;6310;3112322;52074
Midtjylland;2022-05-12;M;81;0;1;6310;3112403;52075
Nordjylland;2022-05-12;M;28;0;1;6310;3112431;52076
Sjælland;2022-05-12;M;49;1;8;6311;3112480;52084
Syddanmark;2022-05-12;M;59;1;6;6312;3112539;52090
Hovedstaden;2022-05-13;F;77;0;10;6312;3112616;52100
Midtjylland;2022-05-13;F;55;1;4;6313;3112671;52104
Nordjylland;2022-05-13;F;20;0;3;6313;3112691;52107
Sjælland;2022-05-13;F;24;0;3;6313;3112715;52110
Syddanmark;2022-05-13;F;57;0;1;6313;3112772;52111
Hovedstaden;2022-05-13;M;56;0;4;6313;3112828;52115
Midtjylland;2022-05-13;M;37;0;3;6313;3112865;52118
Nordjylland;2022-05-13;M;20;1;3;6314;3112885;52121
Sjælland;2022-05-13;M;18;1;3;6315;3112903;52124
Syddanmark;2022-05-13;M;54;0;2;6315;3112957;52126
Hovedstaden;2022-05-14;F;103;0;3;6315;3113060;52129
Midtjylland;2022-05-14;F;53;0;3;6315;3113113;52132
Nordjylland;2022-05-14;F;26;0;4;6315;3113139;52136
Sjælland;2022-05-14;F;26;0;0;6315;3113165;52136
Syddanmark;2022-05-14;F;46;0;0;6315;3113211;52136
Hovedstaden;2022-05-14;M;98;1;7;6316;3113309;52143
Midtjylland;2022-05-14;M;47;1;5;6317;3113356;52148
Nordjylland;2022-05-14;M;14;0;0;6317;3113370;52148
Sjælland;2022-05-14;M;13;0;1;6317;3113383;52149
Syddanmark;2022-05-14;M;59;0;2;6317;3113442;52151
Hovedstaden;2022-05-15;F;122;0;8;6317;3113564;52159
Midtjylland;2022-05-15;F;53;0;5;6317;3113617;52164
Nordjylland;2022-05-15;F;27;0;3;6317;3113644;52167
Sjælland;2022-05-15;F;47;0;1;6317;3113691;52168
Syddanmark;2022-05-15;F;49;0;2;6317;3113740;52170
Hovedstaden;2022-05-15;M;109;1;5;6318;3113849;52175
Midtjylland;2022-05-15;M;48;1;4;6319;3113897;52179
Nordjylland;2022-05-15;M;33;0;3;6319;3113930;52182
Sjælland;2022-05-15;M;42;0;5;6319;3113972;52187
Syddanmark;2022-05-15;M;50;0;4;6319;3114022;52191
Hovedstaden;2022-05-16;F;131;0;6;6319;3114153;52197
Midtjylland;2022-05-16;F;101;0;6;6319;3114254;52203
Nordjylland;2022-05-16;F;26;0;1;6319;3114280;52204
Sjælland;2022-05-16;F;65;0;2;6319;3114345;52206
Syddanmark;2022-05-16;F;89;0;1;6319;3114434;52207
Hovedstaden;2022-05-16;M;116;0;8;6319;3114550;52215
Midtjylland;2022-05-16;M;69;0;1;6319;3114619;52216
Nordjylland;2022-05-16;M;31;0;2;6319;3114650;52218
Sjælland;2022-05-16;M;60;0;3;6319;3114710;52221
Syddanmark;2022-05-16;M;88;2;5;6321;3114798;52226
Hovedstaden;2022-05-17;F;122;0;8;6321;3114920;52234
Midtjylland;2022-05-17;F;83;0;3;6321;3115003;52237
Nordjylland;2022-05-17;F;23;0;0;6321;3115026;52237
Sjælland;2022-05-17;F;65;0;3;6321;3115091;52240
Syddanmark;2022-05-17;F;90;0;4;6321;3115181;52244
Hovedstaden;2022-05-17;M;109;0;8;6321;3115290;52252
Midtjylland;2022-05-17;M;72;1;4;6322;3115362;52256
Nordjylland;2022-05-17;M;30;1;2;6323;3115392;52258
Sjælland;2022-05-17;M;57;0;6;6323;3115449;52264
Syddanmark;2022-05-17;M;89;1;6;6324;3115538;52270
Hovedstaden;2022-05-18;F;107;1;4;6325;3115645;52274
Midtjylland;2022-05-18;F;63;0;1;6325;3115708;52275
Nordjylland;2022-05-18;F;32;1;2;6326;3115740;52277
Sjælland;2022-05-18;F;63;0;1;6326;3115803;52278
Syddanmark;2022-05-18;F;72;0;1;6326;3115875;52279
Hovedstaden;2022-05-18;M;107;1;8;6327;3115982;52287
Midtjylland;2022-05-18;M;69;0;6;6327;3116051;52293
Nordjylland;2022-05-18;M;22;0;2;6327;3116073;52295
Sjælland;2022-05-18;M;58;0;3;6327;3116131;52298
Syddanmark;2022-05-18;M;54;0;0;6327;3116185;52298
Hovedstaden;2022-05-19;F;110;0;11;6327;3116295;52309
Midtjylland;2022-05-19;F;71;1;4;6328;3116366;52313
Nordjylland;2022-05-19;F;21;0;1;6328;3116387;52314
Sjælland;2022-05-19;F;53;1;2;6329;3116440;52316
Syddanmark;2022-05-19;F;74;0;1;6329;3116514;52317
Hovedstaden;2022-05-19;M;107;1;7;6330;3116621;52324
Midtjylland;2022-05-19;M;67;1;4;6331;3116688;52328
Nordjylland;2022-05-19;M;20;1;2;6332;3116708;52330
Sjælland;2022-05-19;M;38;0;1;6332;3116746;52331
Syddanmark;2022-05-19;M;61;0;4;6332;3116807;52335
Hovedstaden;2022-05-20;F;97;0;6;6332;3116904;52341
Midtjylland;2022-05-20;F;63;0;3;6332;3116967;52344
Nordjylland;2022-05-20;F;26;0;2;6332;3116993;52346
Sjælland;2022-05-20;F;39;1;5;6333;3117032;52351
Syddanmark;2022-05-20;F;41;0;2;6333;3117073;52353
Hovedstaden;2022-05-20;M;79;0;5;6333;3117152;52358
Midtjylland;2022-05-20;M;53;1;2;6334;3117205;52360
Nordjylland;2022-05-20;M;18;0;1;6334;3117223;52361
Sjælland;2022-05-20;M;30;0;3;6334;3117253;52364
Syddanmark;2022-05-20;M;36;1;1;6335;3117289;52365
Hovedstaden;2022-05-21;F;62;0;4;6335;3117351;52369
Midtjylland;2022-05-21;F;45;1;3;6336;3117396;52372
Nordjylland;2022-05-21;F;14;1;3;6337;3117410;52375
Sjælland;2022-05-21;F;28;0;5;6337;3117438;52380
Syddanmark;2022-05-21;F;42;0;2;6337;3117480;52382
Hovedstaden;2022-05-21;M;63;1;2;6338;3117543;52384
Midtjylland;2022-05-21;M;36;0;3;6338;3117579;52387
Nordjylland;2022-05-21;M;13;0;1;6338;3117592;52388
Sjælland;2022-05-21;M;18;1;3;6339;3117610;52391
Syddanmark;2022-05-21;M;36;2;5;6341;3117646;52396
Hovedstaden;2022-05-22;F;85;0;4;6341;3117731;52400
Midtjylland;2022-05-22;F;45;0;1;6341;3117776;52401
Nordjylland;2022-05-22;F;15;0;2;6341;3117791;52403
Sjælland;2022-05-22;F;44;0;4;6341;3117835;52407
Syddanmark;2022-05-22;F;37;0;3;6341;3117872;52410
Hovedstaden;2022-05-22;M;70;2;5;6343;3117942;52415
Midtjylland;2022-05-22;M;41;0;3;6343;3117983;52418
Nordjylland;2022-05-22;M;15;1;0;6344;3117998;52418
Sjælland;2022-05-22;M;42;0;1;6344;3118040;52419
Syddanmark;2022-05-22;M;34;1;4;6345;3118074;52423
Hovedstaden;2022-05-23;F;112;2;9;6347;3118186;52432
Midtjylland;2022-05-23;F;69;0;1;6347;3118255;52433
Nordjylland;2022-05-23;F;27;0;2;6347;3118282;52435
Sjælland;2022-05-23;F;42;0;3;6347;3118324;52438
Syddanmark;2022-05-23;F;60;1;3;6348;3118384;52441
Hovedstaden;2022-05-23;M;110;1;4;6349;3118494;52445
Midtjylland;2022-05-23;M;52;0;1;6349;3118546;52446
Nordjylland;2022-05-23;M;22;0;1;6349;3118568;52447
Sjælland;2022-05-23;M;53;0;8;6349;3118621;52455
Syddanmark;2022-05-23;M;52;1;2;6350;3118673;52457
Hovedstaden;2022-05-24;F;112;0;6;6350;3118785;52463
Midtjylland;2022-05-24;F;77;1;1;6351;3118862;52464
Nordjylland;2022-05-24;F;19;1;2;6352;3118881;52466
Sjælland;2022-05-24;F;54;1;4;6353;3118935;52470
Syddanmark;2022-05-24;F;55;0;0;6353;3118990;52470
Hovedstaden;2022-05-24;M;91;0;5;6353;3119081;52475
Midtjylland;2022-05-24;M;56;1;4;6354;3119137;52479
Nordjylland;2022-05-24;M;18;0;0;6354;3119155;52479
Sjælland;2022-05-24;M;35;0;2;6354;3119190;52481
Syddanmark;2022-05-24;M;50;0;1;6354;3119240;52482
Hovedstaden;2022-05-25;F;98;0;4;6354;3119338;52486
Midtjylland;2022-05-25;F;54;0;6;6354;3119392;52492
Nordjylland;2022-05-25;F;27;0;3;6354;3119419;52495
Sjælland;2022-05-25;F;46;1;3;6355;3119465;52498
Syddanmark;2022-05-25;F;44;1;4;6356;3119509;52502
Hovedstaden;2022-05-25;M;88;0;5;6356;3119597;52507
Midtjylland;2022-05-25;M;49;1;2;6357;3119646;52509
Nordjylland;2022-05-25;M;22;0;2;6357;3119668;52511
Sjælland;2022-05-25;M;43;0;4;6357;3119711;52515
Syddanmark;2022-05-25;M;43;0;3;6357;3119754;52518
Hovedstaden;2022-05-26;F;75;0;4;6357;3119829;52522
Midtjylland;2022-05-26;F;35;0;2;6357;3119864;52524
Nordjylland;2022-05-26;F;10;0;1;6357;3119874;52525
Sjælland;2022-05-26;F;16;0;0;6357;3119890;52525
Syddanmark;2022-05-26;F;29;0;0;6357;3119919;52525
Hovedstaden;2022-05-26;M;59;0;5;6357;3119978;52530
Midtjylland;2022-05-26;M;28;0;0;6357;3120006;52530
Nordjylland;2022-05-26;M;13;0;1;6357;3120019;52531
Sjælland;2022-05-26;M;15;0;1;6357;3120034;52532
Syddanmark;2022-05-26;M;28;0;0;6357;3120062;52532
Hovedstaden;2022-05-27;F;87;0;4;6357;3120149;52536
Midtjylland;2022-05-27;F;43;0;1;6357;3120192;52537
Nordjylland;2022-05-27;F;26;0;0;6357;3120218;52537
Sjælland;2022-05-27;F;47;0;5;6357;3120265;52542
Syddanmark;2022-05-27;F;30;0;0;6357;3120295;52542
Hovedstaden;2022-05-27;M;79;0;8;6357;3120374;52550
Midtjylland;2022-05-27;M;47;0;1;6357;3120421;52551
Nordjylland;2022-05-27;M;26;1;3;6358;3120447;52554
Sjælland;2022-05-27;M;50;0;2;6358;3120497;52556
Syddanmark;2022-05-27;M;32;0;2;6358;3120529;52558
Hovedstaden;2022-05-28;F;58;0;4;6358;3120587;52562
Midtjylland;2022-05-28;F;37;0;2;6358;3120624;52564
Nordjylland;2022-05-28;F;15;0;0;6358;3120639;52564
Sjælland;2022-05-28;F;9;0;1;6358;3120648;52565
Syddanmark;2022-05-28;F;48;0;3;6358;3120696;52568
Hovedstaden;2022-05-28;M;74;0;7;6358;3120770;52575
Midtjylland;2022-05-28;M;34;1;2;6359;3120804;52577
Nordjylland;2022-05-28;M;14;0;2;6359;3120818;52579
Sjælland;2022-05-28;M;4;0;2;6359;3120822;52581
Syddanmark;2022-05-28;M;33;0;1;6359;3120855;52582
Hovedstaden;2022-05-29;F;83;0;6;6359;3120938;52588
Midtjylland;2022-05-29;F;46;0;3;6359;3120984;52591
Nordjylland;2022-05-29;F;12;0;0;6359;3120996;52591
Sjælland;2022-05-29;F;64;0;3;6359;3121060;52594
Syddanmark;2022-05-29;F;30;0;1;6359;3121090;52595
Hovedstaden;2022-05-29;M;73;1;5;6360;3121163;52600
Midtjylland;2022-05-29;M;50;1;2;6361;3121213;52602
Nordjylland;2022-05-29;M;14;1;1;6362;3121227;52603
Sjælland;2022-05-29;M;46;0;2;6362;3121273;52605
Syddanmark;2022-05-29;M;26;1;7;6363;3121299;52612
Hovedstaden;2022-05-30;F;133;0;6;6363;3121432;52618
Midtjylland;2022-05-30;F;84;1;3;6364;3121516;52621
Nordjylland;2022-05-30;F;30;0;0;6364;3121546;52621
Sjælland;2022-05-30;F;42;0;3;6364;3121588;52624
Syddanmark;2022-05-30;F;84;0;2;6364;3121672;52626
Hovedstaden;2022-05-30;M;135;3;9;6367;3121807;52635
Midtjylland;2022-05-30;M;69;0;5;6367;3121876;52640
Nordjylland;2022-05-30;M;28;0;1;6367;3121904;52641
Sjælland;2022-05-30;M;43;0;1;6367;3121947;52642
Syddanmark;2022-05-30;M;63;1;2;6368;3122010;52644
Hovedstaden;2022-05-31;F;131;1;5;6369;3122141;52649
Midtjylland;2022-05-31;F;63;0;0;6369;3122204;52649
Nordjylland;2022-05-31;F;25;0;2;6369;3122229;52651
Sjælland;2022-05-31;F;48;1;3;6370;3122277;52654
Syddanmark;2022-05-31;F;77;0;2;6370;3122354;52656
Hovedstaden;2022-05-31;M;106;3;8;6373;3122460;52664
Midtjylland;2022-05-31;M;53;0;2;6373;3122513;52666
Nordjylland;2022-05-31;M;22;0;1;6373;3122535;52667
Sjælland;2022-05-31;M;41;0;2;6373;3122576;52669
Syddanmark;2022-05-31;M;64;0;1;6373;3122640;52670
Hovedstaden;2022-06-01;F;95;0;4;6373;3122735;52674
Midtjylland;2022-06-01;F;59;0;0;6373;3122794;52674
Nordjylland;2022-06-01;F;24;0;1;6373;3122818;52675
Sjælland;2022-06-01;F;61;0;3;6373;3122879;52678
Syddanmark;2022-06-01;F;76;0;6;6373;3122955;52684
Hovedstaden;2022-06-01;M;85;0;2;6373;3123040;52686
Midtjylland;2022-06-01;M;70;0;3;6373;3123110;52689
Nordjylland;2022-06-01;M;20;0;0;6373;3123130;52689
Sjælland;2022-06-01;M;58;0;5;6373;3123188;52694
Syddanmark;2022-06-01;M;37;0;1;6373;3123225;52695
Hovedstaden;2022-06-02;F;81;0;2;6373;3123306;52697
Midtjylland;2022-06-02;F;57;0;3;6373;3123363;52700
Nordjylland;2022-06-02;F;12;0;0;6373;3123375;52700
Sjælland;2022-06-02;F;47;0;2;6373;3123422;52702
Syddanmark;2022-06-02;F;53;0;1;6373;3123475;52703
Hovedstaden;2022-06-02;M;89;0;5;6373;3123564;52708
Midtjylland;2022-06-02;M;65;0;8;6373;3123629;52716
Nordjylland;2022-06-02;M;13;0;1;6373;3123642;52717
Sjælland;2022-06-02;M;54;1;7;6374;3123696;52724
Syddanmark;2022-06-02;M;54;0;1;6374;3123750;52725
Hovedstaden;2022-06-03;F;106;1;5;6375;3123856;52730
Midtjylland;2022-06-03;F;64;0;1;6375;3123920;52731
Nordjylland;2022-06-03;F;33;0;1;6375;3123953;52732
Sjælland;2022-06-03;F;53;0;4;6375;3124006;52736
Syddanmark;2022-06-03;F;56;2;4;6377;3124062;52740
Hovedstaden;2022-06-03;M;76;0;7;6377;3124138;52747
Midtjylland;2022-06-03;M;59;0;2;6377;3124197;52749
Nordjylland;2022-06-03;M;19;0;3;6377;3124216;52752
Sjælland;2022-06-03;M;47;0;0;6377;3124263;52752
Syddanmark;2022-06-03;M;50;0;2;6377;3124313;52754
Hovedstaden;2022-06-04;F;67;0;1;6377;3124380;52755
Midtjylland;2022-06-04;F;44;0;0;6377;3124424;52755
Nordjylland;2022-06-04;F;11;0;1;6377;3124435;52756
Sjælland;2022-06-04;F;3;0;0;6377;3124438;52756
Syddanmark;2022-06-04;F;23;0;2;6377;3124461;52758
Hovedstaden;2022-06-04;M;71;0;2;6377;3124532;52760
Midtjylland;2022-06-04;M;51;1;3;6378;3124583;52763
Nordjylland;2022-06-04;M;11;1;1;6379;3124594;52764
Sjælland;2022-06-04;M;5;0;1;6379;3124599;52765
Syddanmark;2022-06-04;M;14;0;1;6379;3124613;52766
Hovedstaden;2022-06-05;F;68;0;7;6379;3124681;52773
Midtjylland;2022-06-05;F;45;0;3;6379;3124726;52776
Nordjylland;2022-06-05;F;14;0;3;6379;3124740;52779
Sjælland;2022-06-05;F;34;0;4;6379;3124774;52783
Syddanmark;2022-06-05;F;51;0;0;6379;3124825;52783
Hovedstaden;2022-06-05;M;87;1;9;6380;3124912;52792
Midtjylland;2022-06-05;M;38;0;2;6380;3124950;52794
Nordjylland;2022-06-05;M;13;0;3;6380;3124963;52797
Sjælland;2022-06-05;M;26;0;3;6380;3124989;52800
Syddanmark;2022-06-05;M;42;0;2;6380;3125031;52802
Hovedstaden;2022-06-06;F;146;2;6;6382;3125177;52808
Midtjylland;2022-06-06;F;67;0;3;6382;3125244;52811
Nordjylland;2022-06-06;F;24;0;0;6382;3125268;52811
Sjælland;2022-06-06;F;42;0;2;6382;3125310;52813
Syddanmark;2022-06-06;F;71;0;3;6382;3125381;52816
Hovedstaden;2022-06-06;M;114;0;2;6382;3125495;52818
Midtjylland;2022-06-06;M;68;1;2;6383;3125563;52820
Nordjylland;2022-06-06;M;26;0;1;6383;3125589;52821
Sjælland;2022-06-06;M;41;1;4;6384;3125630;52825
Syddanmark;2022-06-06;M;62;1;3;6385;3125692;52828
Hovedstaden;2022-06-07;F;164;0;9;6385;3125856;52837
Midtjylland;2022-06-07;F;89;0;2;6385;3125945;52839
Nordjylland;2022-06-07;F;31;0;1;6385;3125976;52840
Sjælland;2022-06-07;F;83;0;0;6385;3126059;52840
Syddanmark;2022-06-07;F;123;0;2;6385;3126182;52842
Hovedstaden;2022-06-07;M;148;1;8;6386;3126330;52850
Midtjylland;2022-06-07;M;71;0;4;6386;3126401;52854
Nordjylland;2022-06-07;M;25;0;0;6386;3126426;52854
Sjælland;2022-06-07;M;71;1;2;6387;3126497;52856
Syddanmark;2022-06-07;M;94;1;4;6388;3126591;52860
Hovedstaden;2022-06-08;F;188;2;7;6390;3126779;52867
Midtjylland;2022-06-08;F;79;0;1;6390;3126858;52868
Nordjylland;2022-06-08;F;50;0;0;6390;3126908;52868
Sjælland;2022-06-08;F;70;0;0;6390;3126978;52868
Syddanmark;2022-06-08;F;88;1;3;6391;3127066;52871
Hovedstaden;2022-06-08;M;169;1;10;6392;3127235;52881
Midtjylland;2022-06-08;M;74;1;3;6393;3127309;52884
Nordjylland;2022-06-08;M;27;0;1;6393;3127336;52885
Sjælland;2022-06-08;M;63;0;3;6393;3127399;52888
Syddanmark;2022-06-08;M;84;0;5;6393;3127483;52893
Hovedstaden;2022-06-09;F;195;0;8;6393;3127678;52901
Midtjylland;2022-06-09;F;90;0;2;6393;3127768;52903
Nordjylland;2022-06-09;F;23;0;1;6393;3127791;52904
Sjælland;2022-06-09;F;79;1;3;6394;3127870;52907
Syddanmark;2022-06-09;F;67;0;2;6394;3127937;52909
Hovedstaden;2022-06-09;M;157;0;5;6394;3128094;52914
Midtjylland;2022-06-09;M;100;0;2;6394;3128194;52916
Nordjylland;2022-06-09;M;31;0;0;6394;3128225;52916
Sjælland;2022-06-09;M;76;0;1;6394;3128301;52917
Syddanmark;2022-06-09;M;69;0;5;6394;3128370;52922
Hovedstaden;2022-06-10;F;168;1;9;6395;3128538;52931
Midtjylland;2022-06-10;F;66;1;1;6396;3128604;52932
Nordjylland;2022-06-10;F;46;1;1;6397;3128650;52933
Sjælland;2022-06-10;F;63;1;2;6398;3128713;52935
Syddanmark;2022-06-10;F;82;0;2;6398;3128795;52937
Hovedstaden;2022-06-10;M;165;0;10;6398;3128960;52947
Midtjylland;2022-06-10;M;83;0;3;6398;3129043;52950
Nordjylland;2022-06-10;M;37;0;0;6398;3129080;52950
Sjælland;2022-06-10;M;59;1;5;6399;3129139;52955
Syddanmark;2022-06-10;M;73;1;4;6400;3129212;52959
Hovedstaden;2022-06-11;F;176;0;8;6400;3129388;52967
Midtjylland;2022-06-11;F;73;0;2;6400;3129461;52969
Nordjylland;2022-06-11;F;28;0;0;6400;3129489;52969
Sjælland;2022-06-11;F;7;0;3;6400;3129496;52972
Syddanmark;2022-06-11;F;52;0;1;6400;3129548;52973
Hovedstaden;2022-06-11;M;137;0;6;6400;3129685;52979
Midtjylland;2022-06-11;M;72;0;0;6400;3129757;52979
Nordjylland;2022-06-11;M;24;0;0;6400;3129781;52979
Sjælland;2022-06-11;M;16;0;4;6400;3129797;52983
Syddanmark;2022-06-11;M;41;1;5;6401;3129838;52988
Hovedstaden;2022-06-12;F;162;1;6;6402;3130000;52994
Midtjylland;2022-06-12;F;86;0;3;6402;3130086;52997
Nordjylland;2022-06-12;F;20;0;2;6402;3130106;52999
Sjælland;2022-06-12;F;95;1;6;6403;3130201;53005
Syddanmark;2022-06-12;F;93;0;3;6403;3130294;53008
Hovedstaden;2022-06-12;M;171;1;11;6404;3130465;53019
Midtjylland;2022-06-12;M;83;0;4;6404;3130548;53023
Nordjylland;2022-06-12;M;25;0;1;6404;3130573;53024
Sjælland;2022-06-12;M;87;0;3;6404;3130660;53027
Syddanmark;2022-06-12;M;79;0;1;6404;3130739;53028
Hovedstaden;2022-06-13;F;238;1;8;6405;3130977;53036
Midtjylland;2022-06-13;F;107;0;2;6405;3131084;53038
Nordjylland;2022-06-13;F;50;0;1;6405;3131134;53039
Sjælland;2022-06-13;F;88;0;7;6405;3131222;53046
Syddanmark;2022-06-13;F;112;1;8;6406;3131334;53054
Hovedstaden;2022-06-13;M;214;3;11;6409;3131548;53065
Midtjylland;2022-06-13;M;106;1;3;6410;3131654;53068
Nordjylland;2022-06-13;M;53;0;6;6410;3131707;53074
Sjælland;2022-06-13;M;88;1;9;6411;3131795;53083
Syddanmark;2022-06-13;M;104;1;2;6412;3131899;53085
Hovedstaden;2022-06-14;F;230;0;13;6412;3132129;53098
Midtjylland;2022-06-14;F;135;0;7;6412;3132264;53105
Nordjylland;2022-06-14;F;32;0;1;6412;3132296;53106
Sjælland;2022-06-14;F;98;0;5;6412;3132394;53111
Syddanmark;2022-06-14;F;135;0;1;6412;3132529;53112
Hovedstaden;2022-06-14;M;213;4;12;6416;3132742;53124
Midtjylland;2022-06-14;M;107;0;3;6416;3132849;53127
Nordjylland;2022-06-14;M;33;0;1;6416;3132882;53128
Sjælland;2022-06-14;M;90;0;2;6416;3132972;53130
Syddanmark;2022-06-14;M;109;0;3;6416;3133081;53133
Hovedstaden;2022-06-15;F;258;0;5;6416;3133339;53138
Midtjylland;2022-06-15;F;144;0;5;6416;3133483;53143
Nordjylland;2022-06-15;F;48;0;1;6416;3133531;53144
Sjælland;2022-06-15;F;91;0;3;6416;3133622;53147
Syddanmark;2022-06-15;F;108;0;4;6416;3133730;53151
Hovedstaden;2022-06-15;M;229;0;10;6416;3133959;53161
Midtjylland;2022-06-15;M;112;0;2;6416;3134071;53163
Nordjylland;2022-06-15;M;45;0;3;6416;3134116;53166
Sjælland;2022-06-15;M;75;0;5;6416;3134191;53171
Syddanmark;2022-06-15;M;86;1;3;6417;3134277;53174
Hovedstaden;2022-06-16;F;244;4;13;6421;3134521;53187
Midtjylland;2022-06-16;F;137;0;2;6421;3134658;53189
Nordjylland;2022-06-16;F;52;0;2;6421;3134710;53191
Sjælland;2022-06-16;F;101;2;3;6423;3134811;53194
Syddanmark;2022-06-16;F;117;1;4;6424;3134928;53198
Hovedstaden;2022-06-16;M;205;1;7;6425;3135133;53205
Midtjylland;2022-06-16;M;110;0;4;6425;3135243;53209
Nordjylland;2022-06-16;M;36;0;2;6425;3135279;53211
Sjælland;2022-06-16;M;99;1;6;6426;3135378;53217
Syddanmark;2022-06-16;M;98;0;7;6426;3135476;53224
Hovedstaden;2022-06-17;F;227;1;10;6427;3135703;53234
Midtjylland;2022-06-17;F;150;0;1;6427;3135853;53235
Nordjylland;2022-06-17;F;47;0;1;6427;3135900;53236
Sjælland;2022-06-17;F;118;0;6;6427;3136018;53242
Syddanmark;2022-06-17;F;126;0;2;6427;3136144;53244
Hovedstaden;2022-06-17;M;221;1;14;6428;3136365;53258
Midtjylland;2022-06-17;M;119;0;2;6428;3136484;53260
Nordjylland;2022-06-17;M;57;0;1;6428;3136541;53261
Sjælland;2022-06-17;M;103;2;6;6430;3136644;53267
Syddanmark;2022-06-17;M;96;0;3;6430;3136740;53270
Hovedstaden;2022-06-18;F;210;0;10;6430;3136950;53280
Midtjylland;2022-06-18;F;120;0;4;6430;3137070;53284
Nordjylland;2022-06-18;F;28;0;2;6430;3137098;53286
Sjælland;2022-06-18;F;51;0;5;6430;3137149;53291
Syddanmark;2022-06-18;F;45;0;2;6430;3137194;53293
Hovedstaden;2022-06-18;M;222;0;12;6430;3137416;53305
Midtjylland;2022-06-18;M;128;1;6;6431;3137544;53311
Nordjylland;2022-06-18;M;40;0;1;6431;3137584;53312
Sjælland;2022-06-18;M;47;0;2;6431;3137631;53314
Syddanmark;2022-06-18;M;64;1;6;6432;3137695;53320
Hovedstaden;2022-06-19;F;245;0;6;6432;3137940;53326
Midtjylland;2022-06-19;F;131;0;9;6432;3138071;53335
Nordjylland;2022-06-19;F;49;0;1;6432;3138120;53336
Sjælland;2022-06-19;F;39;0;3;6432;3138159;53339
Syddanmark;2022-06-19;F;147;0;0;6432;3138306;53339
Hovedstaden;2022-06-19;M;235;0;8;6432;3138541;53347
Midtjylland;2022-06-19;M;140;0;4;6432;3138681;53351
Nordjylland;2022-06-19;M;39;0;3;6432;3138720;53354
Sjælland;2022-06-19;M;43;0;2;6432;3138763;53356
Syddanmark;2022-06-19;M;114;0;3;6432;3138877;53359
Hovedstaden;2022-06-20;F;337;1;11;6433;3139214;53370
Midtjylland;2022-06-20;F;189;0;4;6433;3139403;53374
Nordjylland;2022-06-20;F;85;0;2;6433;3139488;53376
Sjælland;2022-06-20;F;190;0;6;6433;3139678;53382
Syddanmark;2022-06-20;F;175;1;10;6434;3139853;53392
Hovedstaden;2022-06-20;M;318;0;8;6434;3140171;53400
Midtjylland;2022-06-20;M;162;1;5;6435;3140333;53405
Nordjylland;2022-06-20;M;75;0;2;6435;3140408;53407
Sjælland;2022-06-20;M;201;1;8;6436;3140609;53415
Syddanmark;2022-06-20;M;150;0;3;6436;3140759;53418
Hovedstaden;2022-06-21;F;355;1;19;6437;3141114;53437
Midtjylland;2022-06-21;F;193;0;4;6437;3141307;53441
Nordjylland;2022-06-21;F;72;0;6;6437;3141379;53447
Sjælland;2022-06-21;F;174;0;2;6437;3141553;53449
Syddanmark;2022-06-21;F;194;1;6;6438;3141747;53455
Hovedstaden;2022-06-21;M;372;1;14;6439;3142119;53469
Midtjylland;2022-06-21;M;179;2;5;6441;3142298;53474
Nordjylland;2022-06-21;M;65;0;2;6441;3142363;53476
Sjælland;2022-06-21;M;154;0;8;6441;3142517;53484
Syddanmark;2022-06-21;M;178;0;5;6441;3142695;53489
Hovedstaden;2022-06-22;F;356;2;23;6443;3143051;53512
Midtjylland;2022-06-22;F;169;0;7;6443;3143220;53519
Nordjylland;2022-06-22;F;107;0;4;6443;3143327;53523
Sjælland;2022-06-22;F;123;1;4;6444;3143450;53527
Syddanmark;2022-06-22;F;156;1;5;6445;3143606;53532
Hovedstaden;2022-06-22;M;344;2;13;6447;3143950;53545
Midtjylland;2022-06-22;M;171;0;6;6447;3144121;53551
Nordjylland;2022-06-22;M;85;0;5;6447;3144206;53556
Sjælland;2022-06-22;M;140;1;7;6448;3144346;53563
Syddanmark;2022-06-22;M;153;2;7;6450;3144499;53570
Hovedstaden;2022-06-23;F;312;0;13;6450;3144811;53583
Midtjylland;2022-06-23;F;142;0;3;6450;3144953;53586
Nordjylland;2022-06-23;F;47;0;4;6450;3145000;53590
Sjælland;2022-06-23;F;111;0;4;6450;3145111;53594
Syddanmark;2022-06-23;F;143;1;9;6451;3145254;53603
Hovedstaden;2022-06-23;M;271;2;19;6453;3145525;53622
Midtjylland;2022-06-23;M;138;1;7;6454;3145663;53629
Nordjylland;2022-06-23;M;46;0;1;6454;3145709;53630
Sjælland;2022-06-23;M;106;0;7;6454;3145815;53637
Syddanmark;2022-06-23;M;118;2;9;6456;3145933;53646
Hovedstaden;2022-06-24;F;270;1;13;6457;3146203;53659
Midtjylland;2022-06-24;F;121;1;6;6458;3146324;53665
Nordjylland;2022-06-24;F;80;0;2;6458;3146404;53667
Sjælland;2022-06-24;F;103;1;12;6459;3146507;53679
Syddanmark;2022-06-24;F;118;0;6;6459;3146625;53685
Hovedstaden;2022-06-24;M;239;2;15;6461;3146864;53700
Midtjylland;2022-06-24;M;108;0;8;6461;3146972;53708
Nordjylland;2022-06-24;M;54;0;3;6461;3147026;53711
Sjælland;2022-06-24;M;94;1;2;6462;3147120;53713
Syddanmark;2022-06-24;M;96;1;7;6463;3147216;53720
Hovedstaden;2022-06-25;F;166;0;10;6463;3147382;53730
Midtjylland;2022-06-25;F;82;1;6;6464;3147464;53736
Nordjylland;2022-06-25;F;23;0;1;6464;3147487;53737
Sjælland;2022-06-25;F;34;0;4;6464;3147521;53741
Syddanmark;2022-06-25;F;52;2;3;6466;3147573;53744
Hovedstaden;2022-06-25;M;159;1;13;6467;3147732;53757
Midtjylland;2022-06-25;M;79;0;7;6467;3147811;53764
Nordjylland;2022-06-25;M;24;0;1;6467;3147835;53765
Sjælland;2022-06-25;M;33;1;4;6468;3147868;53769
Syddanmark;2022-06-25;M;53;1;6;6469;3147921;53775
Hovedstaden;2022-06-26;F;360;1;17;6470;3148281;53792
Midtjylland;2022-06-26;F;183;0;4;6470;3148464;53796
Nordjylland;2022-06-26;F;56;0;4;6470;3148520;53800
Sjælland;2022-06-26;F;62;0;6;6470;3148582;53806
Syddanmark;2022-06-26;F;17;1;9;6471;3148599;53815
Hovedstaden;2022-06-26;M;315;0;13;6471;3148914;53828
Midtjylland;2022-06-26;M;163;0;6;6471;3149077;53834
Nordjylland;2022-06-26;M;55;0;1;6471;3149132;53835
Sjælland;2022-06-26;M;56;0;7;6471;3149188;53842
Syddanmark;2022-06-26;M;5;0;4;6471;3149193;53846
Hovedstaden;2022-06-27;F;477;0;18;6471;3149670;53864
Midtjylland;2022-06-27;F;229;0;10;6471;3149899;53874
Nordjylland;2022-06-27;F;122;0;5;6471;3150021;53879
Sjælland;2022-06-27;F;256;0;3;6471;3150277;53882
Syddanmark;2022-06-27;F;351;1;6;6472;3150628;53888
Hovedstaden;2022-06-27;M;388;2;18;6474;3151016;53906
Midtjylland;2022-06-27;M;220;1;7;6475;3151236;53913
Nordjylland;2022-06-27;M;115;0;3;6475;3151351;53916
Sjælland;2022-06-27;M;245;1;11;6476;3151596;53927
Syddanmark;2022-06-27;M;373;1;4;6477;3151969;53931
Hovedstaden;2022-06-28;F;386;0;19;6477;3152355;53950
Midtjylland;2022-06-28;F;262;0;10;6477;3152617;53960
Nordjylland;2022-06-28;F;89;0;3;6477;3152706;53963
Sjælland;2022-06-28;F;186;1;4;6478;3152892;53967
Syddanmark;2022-06-28;F;320;1;3;6479;3153212;53970
Hovedstaden;2022-06-28;M;364;1;14;6480;3153576;53984
Midtjylland;2022-06-28;M;207;0;14;6480;3153783;53998
Nordjylland;2022-06-28;M;66;0;4;6480;3153849;54002
Sjælland;2022-06-28;M;133;0;7;6480;3153982;54009
Syddanmark;2022-06-28;M;267;0;7;6480;3154249;54016
Hovedstaden;2022-06-29;F;342;2;24;6482;3154591;54040
Midtjylland;2022-06-29;F;243;0;5;6482;3154834;54045
Nordjylland;2022-06-29;F;108;0;2;6482;3154942;54047
Sjælland;2022-06-29;F;149;0;5;6482;3155091;54052
Syddanmark;2022-06-29;F;261;0;5;6482;3155352;54057
Hovedstaden;2022-06-29;M;331;1;17;6483;3155683;54074
Midtjylland;2022-06-29;M;193;3;7;6486;3155876;54081
Nordjylland;2022-06-29;M;93;0;8;6486;3155969;54089
Sjælland;2022-06-29;M;133;0;1;6486;3156102;54090
Syddanmark;2022-06-29;M;279;1;6;6487;3156381;54096
Hovedstaden;2022-06-30;F;329;0;11;6487;3156710;54107
Midtjylland;2022-06-30;F;186;1;6;6488;3156896;54113
Nordjylland;2022-06-30;F;79;0;3;6488;3156975;54116
Sjælland;2022-06-30;F;140;0;4;6488;3157115;54120
Syddanmark;2022-06-30;F;205;0;3;6488;3157320;54123
Hovedstaden;2022-06-30;M;270;0;11;6488;3157590;54134
Midtjylland;2022-06-30;M;179;0;7;6488;3157769;54141
Nordjylland;2022-06-30;M;56;0;3;6488;3157825;54144
Sjælland;2022-06-30;M;111;1;8;6489;3157936;54152
Syddanmark;2022-06-30;M;199;1;7;6490;3158135;54159
Hovedstaden;2022-07-01;F;283;0;13;6490;3158418;54172
Midtjylland;2022-07-01;F;185;0;3;6490;3158603;54175
Nordjylland;2022-07-01;F;88;0;0;6490;3158691;54175
Sjælland;2022-07-01;F;125;0;2;6490;3158816;54177
Syddanmark;2022-07-01;F;190;0;3;6490;3159006;54180
Hovedstaden;2022-07-01;M;222;3;19;6493;3159228;54199
Midtjylland;2022-07-01;M;152;0;5;6493;3159380;54204
Nordjylland;2022-07-01;M;89;1;5;6494;3159469;54209
Sjælland;2022-07-01;M;94;0;6;6494;3159563;54215
Syddanmark;2022-07-01;M;186;0;8;6494;3159749;54223
Hovedstaden;2022-07-02;F;214;0;14;6494;3159963;54237
Midtjylland;2022-07-02;F;130;0;1;6494;3160093;54238
Nordjylland;2022-07-02;F;52;0;1;6494;3160145;54239
Sjælland;2022-07-02;F;48;0;6;6494;3160193;54245
Syddanmark;2022-07-02;F;91;1;5;6495;3160284;54250
Hovedstaden;2022-07-02;M;199;0;12;6495;3160483;54262
Midtjylland;2022-07-02;M;125;0;7;6495;3160608;54269
Nordjylland;2022-07-02;M;49;1;4;6496;3160657;54273
Sjælland;2022-07-02;M;48;1;4;6497;3160705;54277
Syddanmark;2022-07-02;M;105;1;9;6498;3160810;54286
Hovedstaden;2022-07-03;F;307;1;14;6499;3161117;54300
Midtjylland;2022-07-03;F;141;0;4;6499;3161258;54304
Nordjylland;2022-07-03;F;58;0;2;6499;3161316;54306
Sjælland;2022-07-03;F;111;0;6;6499;3161427;54312
Syddanmark;2022-07-03;F;163;0;6;6499;3161590;54318
Hovedstaden;2022-07-03;M;255;1;12;6500;3161845;54330
Midtjylland;2022-07-03;M;138;0;8;6500;3161983;54338
Nordjylland;2022-07-03;M;38;1;2;6501;3162021;54340
Sjælland;2022-07-03;M;104;1;4;6502;3162125;54344
Syddanmark;2022-07-03;M;146;0;5;6502;3162271;54349
Hovedstaden;2022-07-04;F;511;0;15;6502;3162782;54364
Midtjylland;2022-07-04;F;221;0;7;6502;3163003;54371
Nordjylland;2022-07-04;F;128;0;2;6502;3163131;54373
Sjælland;2022-07-04;F;242;0;6;6502;3163373;54379
Syddanmark;2022-07-04;F;329;5;9;6507;3163702;54388
Hovedstaden;2022-07-04;M;423;1;27;6508;3164125;54415
Midtjylland;2022-07-04;M;228;1;6;6509;3164353;54421
Nordjylland;2022-07-04;M;110;1;6;6510;3164463;54427
Sjælland;2022-07-04;M;208;0;6;6510;3164671;54433
Syddanmark;2022-07-04;M;280;0;6;6510;3164951;54439
Hovedstaden;2022-07-05;F;534;0;16;6510;3165485;54455
Midtjylland;2022-07-05;F;246;2;8;6512;3165731;54463
Nordjylland;2022-07-05;F;119;0;4;6512;3165850;54467
Sjælland;2022-07-05;F;265;0;9;6512;3166115;54476
Syddanmark;2022-07-05;F;259;1;5;6513;3166374;54481
Hovedstaden;2022-07-05;M;489;0;13;6513;3166863;54494
Midtjylland;2022-07-05;M;178;0;9;6513;3167041;54503
Nordjylland;2022-07-05;M;116;0;5;6513;3167157;54508
Sjælland;2022-07-05;M;244;0;7;6513;3167401;54515
Syddanmark;2022-07-05;M;265;0;11;6513;3167666;54526
Hovedstaden;2022-07-06;F;548;1;17;6514;3168214;54543
Midtjylland;2022-07-06;F;231;0;4;6514;3168445;54547
Nordjylland;2022-07-06;F;164;1;3;6515;3168609;54550
Sjælland;2022-07-06;F;237;0;7;6515;3168846;54557
Syddanmark;2022-07-06;F;270;0;6;6515;3169116;54563
Hovedstaden;2022-07-06;M;458;1;10;6516;3169574;54573
Midtjylland;2022-07-06;M;193;0;8;6516;3169767;54581
Nordjylland;2022-07-06;M;165;0;5;6516;3169932;54586
Sjælland;2022-07-06;M;223;1;11;6517;3170155;54597
Syddanmark;2022-07-06;M;234;2;11;6519;3170389;54608
Hovedstaden;2022-07-07;F;475;1;17;6520;3170864;54625
Midtjylland;2022-07-07;F;225;1;9;6521;3171089;54634
Nordjylland;2022-07-07;F;128;0;2;6521;3171217;54636
Sjælland;2022-07-07;F;173;0;8;6521;3171390;54644
Syddanmark;2022-07-07;F;204;0;5;6521;3171594;54649
Hovedstaden;2022-07-07;M;389;0;26;6521;3171983;54675
Midtjylland;2022-07-07;M;193;0;6;6521;3172176;54681
Nordjylland;2022-07-07;M;112;1;6;6522;3172288;54687
Sjælland;2022-07-07;M;177;1;9;6523;3172465;54696
Syddanmark;2022-07-07;M;195;0;4;6523;3172660;54700
Hovedstaden;2022-07-08;F;444;2;18;6525;3173104;54718
Midtjylland;2022-07-08;F;188;0;6;6525;3173292;54724
Nordjylland;2022-07-08;F;162;2;8;6527;3173454;54732
Sjælland;2022-07-08;F;180;1;11;6528;3173634;54743
Syddanmark;2022-07-08;F;200;2;7;6530;3173834;54750
Hovedstaden;2022-07-08;M;331;1;16;6531;3174165;54766
Midtjylland;2022-07-08;M;196;0;10;6531;3174361;54776
Nordjylland;2022-07-08;M;129;0;6;6531;3174490;54782
Sjælland;2022-07-08;M;194;1;5;6532;3174684;54787
Syddanmark;2022-07-08;M;196;2;5;6534;3174880;54792
Hovedstaden;2022-07-09;F;327;1;15;6535;3175207;54807
Midtjylland;2022-07-09;F;145;1;4;6536;3175352;54811
Nordjylland;2022-07-09;F;79;0;7;6536;3175431;54818
Sjælland;2022-07-09;F;90;0;8;6536;3175521;54826
Syddanmark;2022-07-09;F;101;1;5;6537;3175622;54831
Hovedstaden;2022-07-09;M;280;0;14;6537;3175902;54845
Midtjylland;2022-07-09;M;137;1;4;6538;3176039;54849
Nordjylland;2022-07-09;M;53;0;5;6538;3176092;54854
Sjælland;2022-07-09;M;106;0;8;6538;3176198;54862
Syddanmark;2022-07-09;M;97;1;9;6539;3176295;54871
Hovedstaden;2022-07-10;F;396;1;21;6540;3176691;54892
Midtjylland;2022-07-10;F;198;0;4;6540;3176889;54896
Nordjylland;2022-07-10;F;84;0;5;6540;3176973;54901
Sjælland;2022-07-10;F;148;0;5;6540;3177121;54906
Syddanmark;2022-07-10;F;221;1;9;6541;3177342;54915
Hovedstaden;2022-07-10;M;288;4;25;6545;3177630;54940
Midtjylland;2022-07-10;M;163;1;11;6546;3177793;54951
Nordjylland;2022-07-10;M;74;0;4;6546;3177867;54955
Sjælland;2022-07-10;M;135;1;8;6547;3178002;54963
Syddanmark;2022-07-10;M;191;1;5;6548;3178193;54968
Hovedstaden;2022-07-11;F;524;2;26;6550;3178717;54994
Midtjylland;2022-07-11;F;247;1;8;6551;3178964;55002
Nordjylland;2022-07-11;F;166;0;3;6551;3179130;55005
Sjælland;2022-07-11;F;331;0;13;6551;3179461;55018
Syddanmark;2022-07-11;F;314;1;4;6552;3179775;55022
Hovedstaden;2022-07-11;M;403;2;20;6554;3180178;55042
Midtjylland;2022-07-11;M;251;1;17;6555;3180429;55059
Nordjylland;2022-07-11;M;148;0;7;6555;3180577;55066
Sjælland;2022-07-11;M;280;0;10;6555;3180857;55076
Syddanmark;2022-07-11;M;266;3;9;6558;3181123;55085
Hovedstaden;2022-07-12;F;439;4;22;6562;3181562;55107
Midtjylland;2022-07-12;F;251;1;9;6563;3181813;55116
Nordjylland;2022-07-12;F;126;1;7;6564;3181939;55123
Sjælland;2022-07-12;F;240;0;12;6564;3182179;55135
Syddanmark;2022-07-12;F;293;0;8;6564;3182472;55143
Hovedstaden;2022-07-12;M;403;2;33;6566;3182875;55176
Midtjylland;2022-07-12;M;191;0;3;6566;3183066;55179
Nordjylland;2022-07-12;M;100;2;8;6568;3183166;55187
Sjælland;2022-07-12;M;196;0;8;6568;3183362;55195
Syddanmark;2022-07-12;M;253;1;12;6569;3183615;55207
Hovedstaden;2022-07-13;F;428;2;26;6571;3184043;55233
Midtjylland;2022-07-13;F;230;0;7;6571;3184273;55240
Nordjylland;2022-07-13;F;156;1;4;6572;3184429;55244
Sjælland;2022-07-13;F;254;1;16;6573;3184683;55260
Syddanmark;2022-07-13;F;247;0;17;6573;3184930;55277
Hovedstaden;2022-07-13;M;351;1;18;6574;3185281;55295
Midtjylland;2022-07-13;M;197;0;6;6574;3185478;55301
Nordjylland;2022-07-13;M;126;1;10;6575;3185604;55311
Sjælland;2022-07-13;M;221;3;16;6578;3185825;55327
Syddanmark;2022-07-13;M;240;4;13;6582;3186065;55340
Hovedstaden;2022-07-14;F;352;2;17;6584;3186417;55357
Midtjylland;2022-07-14;F;213;0;5;6584;3186630;55362
Nordjylland;2022-07-14;F;105;0;3;6584;3186735;55365
Sjælland;2022-07-14;F;228;0;12;6584;3186963;55377
Syddanmark;2022-07-14;F;217;2;12;6586;3187180;55389
Hovedstaden;2022-07-14;M;381;0;26;6586;3187561;55415
Midtjylland;2022-07-14;M;188;0;7;6586;3187749;55422
Nordjylland;2022-07-14;M;98;1;5;6587;3187847;55427
Sjælland;2022-07-14;M;183;1;8;6588;3188030;55435
Syddanmark;2022-07-14;M;173;0;9;6588;3188203;55444
Hovedstaden;2022-07-15;F;372;1;24;6589;3188575;55468
Midtjylland;2022-07-15;F;237;0;8;6589;3188812;55476
Nordjylland;2022-07-15;F;133;1;7;6590;3188945;55483
Sjælland;2022-07-15;F;186;1;5;6591;3189131;55488
Syddanmark;2022-07-15;F;229;0;4;6591;3189360;55492
Hovedstaden;2022-07-15;M;322;1;17;6592;3189682;55509
Midtjylland;2022-07-15;M;192;1;7;6593;3189874;55516
Nordjylland;2022-07-15;M;95;1;4;6594;3189969;55520
Sjælland;2022-07-15;M;184;0;14;6594;3190153;55534
Syddanmark;2022-07-15;M;218;2;4;6596;3190371;55538
Hovedstaden;2022-07-16;F;305;1;20;6597;3190676;55558
Midtjylland;2022-07-16;F;161;0;3;6597;3190837;55561
Nordjylland;2022-07-16;F;65;0;5;6597;3190902;55566
Sjælland;2022-07-16;F;104;0;9;6597;3191006;55575
Syddanmark;2022-07-16;F;68;0;4;6597;3191074;55579
Hovedstaden;2022-07-16;M;268;5;28;6602;3191342;55607
Midtjylland;2022-07-16;M;175;1;7;6603;3191517;55614
Nordjylland;2022-07-16;M;61;0;2;6603;3191578;55616
Sjælland;2022-07-16;M;87;0;5;6603;3191665;55621
Syddanmark;2022-07-16;M;88;1;11;6604;3191753;55632
Hovedstaden;2022-07-17;F;321;1;20;6605;3192074;55652
Midtjylland;2022-07-17;F;243;0;12;6605;3192317;55664
Nordjylland;2022-07-17;F;74;0;3;6605;3192391;55667
Sjælland;2022-07-17;F;172;0;9;6605;3192563;55676
Syddanmark;2022-07-17;F;232;1;11;6606;3192795;55687
Hovedstaden;2022-07-17;M;276;3;28;6609;3193071;55715
Midtjylland;2022-07-17;M;164;1;8;6610;3193235;55723
Nordjylland;2022-07-17;M;67;0;4;6610;3193302;55727
Sjælland;2022-07-17;M;147;0;12;6610;3193449;55739
Syddanmark;2022-07-17;M;187;2;17;6612;3193636;55756
Hovedstaden;2022-07-18;F;432;1;28;6613;3194068;55784
Midtjylland;2022-07-18;F;311;1;13;6614;3194379;55797
Nordjylland;2022-07-18;F;149;2;7;6616;3194528;55804
Sjælland;2022-07-18;F;262;1;13;6617;3194790;55817
Syddanmark;2022-07-18;F;348;2;9;6619;3195138;55826
Hovedstaden;2022-07-18;M;346;4;41;6623;3195484;55867
Midtjylland;2022-07-18;M;275;0;8;6623;3195759;55875
Nordjylland;2022-07-18;M;160;2;9;6625;3195919;55884
Sjælland;2022-07-18;M;211;2;14;6627;3196130;55898
Syddanmark;2022-07-18;M;281;2;18;6629;3196411;55916
Hovedstaden;2022-07-19;F;352;1;30;6630;3196763;55946
Midtjylland;2022-07-19;F;244;1;10;6631;3197007;55956
Nordjylland;2022-07-19;F;114;0;5;6631;3197121;55961
Sjælland;2022-07-19;F;209;0;4;6631;3197330;55965
Syddanmark;2022-07-19;F;265;0;9;6631;3197595;55974
Hovedstaden;2022-07-19;M;285;1;23;6632;3197880;55997
Midtjylland;2022-07-19;M;195;1;8;6633;3198075;56005
Nordjylland;2022-07-19;M;88;1;6;6634;3198163;56011
Sjælland;2022-07-19;M;204;1;10;6635;3198367;56021
Syddanmark;2022-07-19;M;254;0;12;6635;3198621;56033
Hovedstaden;2022-07-20;F;371;3;29;6638;3198992;56062
Midtjylland;2022-07-20;F;180;1;5;6639;3199172;56067
Nordjylland;2022-07-20;F;111;1;2;6640;3199283;56069
Sjælland;2022-07-20;F;194;0;7;6640;3199477;56076
Syddanmark;2022-07-20;F;195;3;8;6643;3199672;56084
Hovedstaden;2022-07-20;M;313;2;28;6645;3199985;56112
Midtjylland;2022-07-20;M;195;1;9;6646;3200180;56121
Nordjylland;2022-07-20;M;103;0;8;6646;3200283;56129
Sjælland;2022-07-20;M;179;1;11;6647;3200462;56140
Syddanmark;2022-07-20;M;190;1;8;6648;3200652;56148
Hovedstaden;2022-07-21;F;319;1;19;6649;3200971;56167
Midtjylland;2022-07-21;F;199;1;3;6650;3201170;56170
Nordjylland;2022-07-21;F;103;0;3;6650;3201273;56173
Sjælland;2022-07-21;F;190;1;9;6651;3201463;56182
Syddanmark;2022-07-21;F;191;2;9;6653;3201654;56191
Hovedstaden;2022-07-21;M;285;2;18;6655;3201939;56209
Midtjylland;2022-07-21;M;168;2;6;6657;3202107;56215
Nordjylland;2022-07-21;M;79;0;8;6657;3202186;56223
Sjælland;2022-07-21;M;174;2;8;6659;3202360;56231
Syddanmark;2022-07-21;M;158;2;13;6661;3202518;56244
Hovedstaden;2022-07-22;F;306;6;22;6667;3202824;56266
Midtjylland;2022-07-22;F;225;0;8;6667;3203049;56274
Nordjylland;2022-07-22;F;111;0;5;6667;3203160;56279
Sjælland;2022-07-22;F;182;1;6;6668;3203342;56285
Syddanmark;2022-07-22;F;183;1;11;6669;3203525;56296
Hovedstaden;2022-07-22;M;238;0;16;6669;3203763;56312
Midtjylland;2022-07-22;M;171;0;6;6669;3203934;56318
Nordjylland;2022-07-22;M;89;0;10;6669;3204023;56328
Sjælland;2022-07-22;M;136;1;9;6670;3204159;56337
Syddanmark;2022-07-22;M;164;3;14;6673;3204323;56351
Hovedstaden;2022-07-23;F;250;3;17;6676;3204573;56368
Midtjylland;2022-07-23;F;146;1;10;6677;3204719;56378
Nordjylland;2022-07-23;F;59;0;1;6677;3204778;56379
Sjælland;2022-07-23;F;62;0;5;6677;3204840;56384
Syddanmark;2022-07-23;F;82;0;3;6677;3204922;56387
Hovedstaden;2022-07-23;M;249;0;12;6677;3205171;56399
Midtjylland;2022-07-23;M;122;0;2;6677;3205293;56401
Nordjylland;2022-07-23;M;41;1;2;6678;3205334;56403
Sjælland;2022-07-23;M;74;1;9;6679;3205408;56412
Syddanmark;2022-07-23;M;58;0;8;6679;3205466;56420
Hovedstaden;2022-07-24;F;240;1;10;6680;3205706;56430
Midtjylland;2022-07-24;F;162;0;6;6680;3205868;56436
Nordjylland;2022-07-24;F;60;0;2;6680;3205928;56438
Sjælland;2022-07-24;F;112;0;7;6680;3206040;56445
Syddanmark;2022-07-24;F;169;0;5;6680;3206209;56450
Hovedstaden;2022-07-24;M;205;2;17;6682;3206414;56467
Midtjylland;2022-07-24;M;155;0;12;6682;3206569;56479
Nordjylland;2022-07-24;M;43;0;4;6682;3206612;56483
Sjælland;2022-07-24;M;112;1;5;6683;3206724;56488
Syddanmark;2022-07-24;M;142;0;10;6683;3206866;56498
Hovedstaden;2022-07-25;F;301;0;15;6683;3207167;56513
Midtjylland;2022-07-25;F;218;2;6;6685;3207385;56519
Nordjylland;2022-07-25;F;101;1;3;6686;3207486;56522
Sjælland;2022-07-25;F;182;0;8;6686;3207668;56530
Syddanmark;2022-07-25;F;284;1;8;6687;3207952;56538
Hovedstaden;2022-07-25;M;274;2;19;6689;3208226;56557
Midtjylland;2022-07-25;M;212;1;8;6690;3208438;56565
Nordjylland;2022-07-25;M;102;1;3;6691;3208540;56568
Sjælland;2022-07-25;M;151;2;11;6693;3208691;56579
Syddanmark;2022-07-25;M;244;2;12;6695;3208935;56591
Hovedstaden;2022-07-26;F;279;1;12;6696;3209214;56603
Midtjylland;2022-07-26;F;219;1;8;6697;3209433;56611
Nordjylland;2022-07-26;F;75;1;5;6698;3209508;56616
Sjælland;2022-07-26;F;162;1;12;6699;3209670;56628
Syddanmark;2022-07-26;F;229;1;8;6700;3209899;56636
Hovedstaden;2022-07-26;M;235;0;10;6700;3210134;56646
Midtjylland;2022-07-26;M;180;2;15;6702;3210314;56661
Nordjylland;2022-07-26;M;71;1;3;6703;3210385;56664
Sjælland;2022-07-26;M;148;0;9;6703;3210533;56673
Syddanmark;2022-07-26;M;197;2;3;6705;3210730;56676
Hovedstaden;2022-07-27;F;232;1;17;6706;3210962;56693
Midtjylland;2022-07-27;F;176;2;2;6708;3211138;56695
Nordjylland;2022-07-27;F;81;0;1;6708;3211219;56696
Sjælland;2022-07-27;F;125;0;4;6708;3211344;56700
Syddanmark;2022-07-27;F;175;1;5;6709;3211519;56705
Hovedstaden;2022-07-27;M;222;2;20;6711;3211741;56725
Midtjylland;2022-07-27;M;179;1;6;6712;3211920;56731
Nordjylland;2022-07-27;M;70;1;3;6713;3211990;56734
Sjælland;2022-07-27;M;123;1;3;6714;3212113;56737
Syddanmark;2022-07-27;M;149;2;8;6716;3212262;56745
Hovedstaden;2022-07-28;F;234;0;11;6716;3212496;56756
Midtjylland;2022-07-28;F;169;2;5;6718;3212665;56761
Nordjylland;2022-07-28;F;54;0;3;6718;3212719;56764
Sjælland;2022-07-28;F;131;0;3;6718;3212850;56767
Syddanmark;2022-07-28;F;141;1;11;6719;3212991;56778
Hovedstaden;2022-07-28;M;183;3;19;6722;3213174;56797
Midtjylland;2022-07-28;M;166;0;5;6722;3213340;56802
Nordjylland;2022-07-28;M;54;0;2;6722;3213394;56804
Sjælland;2022-07-28;M;115;0;5;6722;3213509;56809
Syddanmark;2022-07-28;M;134;1;8;6723;3213643;56817
Hovedstaden;2022-07-29;F;213;1;18;6724;3213856;56835
Midtjylland;2022-07-29;F;163;0;7;6724;3214019;56842
Nordjylland;2022-07-29;F;69;0;6;6724;3214088;56848
Sjælland;2022-07-29;F;102;0;3;6724;3214190;56851
Syddanmark;2022-07-29;F;157;1;4;6725;3214347;56855
Hovedstaden;2022-07-29;M;168;2;13;6727;3214515;56868
Midtjylland;2022-07-29;M;136;0;8;6727;3214651;56876
Nordjylland;2022-07-29;M;70;0;5;6727;3214721;56881
Sjælland;2022-07-29;M;110;1;11;6728;3214831;56892
Syddanmark;2022-07-29;M;149;2;7;6730;3214980;56899
Hovedstaden;2022-07-30;F;215;3;19;6733;3215195;56918
Midtjylland;2022-07-30;F;153;0;7;6733;3215348;56925
Nordjylland;2022-07-30;F;43;0;5;6733;3215391;56930
Sjælland;2022-07-30;F;77;1;6;6734;3215468;56936
Syddanmark;2022-07-30;F;100;2;8;6736;3215568;56944
Hovedstaden;2022-07-30;M;182;1;8;6737;3215750;56952
Midtjylland;2022-07-30;M;125;1;6;6738;3215875;56958
Nordjylland;2022-07-30;M;41;0;3;6738;3215916;56961
Sjælland;2022-07-30;M;83;0;8;6738;3215999;56969
Syddanmark;2022-07-30;M;79;0;9;6738;3216078;56978
Hovedstaden;2022-07-31;F;254;1;16;6739;3216332;56994
Midtjylland;2022-07-31;F;205;1;9;6740;3216537;57003
Nordjylland;2022-07-31;F;78;1;5;6741;3216615;57008
Sjælland;2022-07-31;F;136;0;7;6741;3216751;57015
Syddanmark;2022-07-31;F;161;1;7;6742;3216912;57022
Hovedstaden;2022-07-31;M;185;1;14;6743;3217097;57036
Midtjylland;2022-07-31;M;147;1;8;6744;3217244;57044
Nordjylland;2022-07-31;M;53;0;0;6744;3217297;57044
Sjælland;2022-07-31;M;94;1;6;6745;3217391;57050
Syddanmark;2022-07-31;M;136;1;8;6746;3217527;57058
Hovedstaden;2022-08-01;F;294;0;19;6746;3217821;57077
Midtjylland;2022-08-01;F;212;0;7;6746;3218033;57084
Nordjylland;2022-08-01;F;118;1;5;6747;3218151;57089
Sjælland;2022-08-01;F;210;1;11;6748;3218361;57100
Syddanmark;2022-08-01;F;249;4;13;6752;3218610;57113
Hovedstaden;2022-08-01;M;249;3;16;6755;3218859;57129
Midtjylland;2022-08-01;M;190;2;4;6757;3219049;57133
Nordjylland;2022-08-01;M;83;1;1;6758;3219132;57134
Sjælland;2022-08-01;M;173;0;7;6758;3219305;57141
Syddanmark;2022-08-01;M;205;0;8;6758;3219510;57149
Hovedstaden;2022-08-02;F;276;3;15;6761;3219786;57164
Midtjylland;2022-08-02;F;175;1;5;6762;3219961;57169
Nordjylland;2022-08-02;F;66;0;2;6762;3220027;57171
Sjælland;2022-08-02;F;171;1;12;6763;3220198;57183
Syddanmark;2022-08-02;F;227;0;5;6763;3220425;57188
Hovedstaden;2022-08-02;M;249;0;10;6763;3220674;57198
Midtjylland;2022-08-02;M;186;1;5;6764;3220860;57203
Nordjylland;2022-08-02;M;67;1;3;6765;3220927;57206
Sjælland;2022-08-02;M;145;0;5;6765;3221072;57211
Syddanmark;2022-08-02;M;230;1;7;6766;3221302;57218
Hovedstaden;2022-08-03;F;245;0;6;6766;3221547;57224
Midtjylland;2022-08-03;F;185;0;6;6766;3221732;57230
Nordjylland;2022-08-03;F;84;0;5;6766;3221816;57235
Sjælland;2022-08-03;F;167;2;13;6768;3221983;57248
Syddanmark;2022-08-03;F;196;1;5;6769;3222179;57253
Hovedstaden;2022-08-03;M;220;2;19;6771;3222399;57272
Midtjylland;2022-08-03;M;176;2;7;6773;3222575;57279
Nordjylland;2022-08-03;M;83;0;4;6773;3222658;57283
Sjælland;2022-08-03;M;149;0;6;6773;3222807;57289
Syddanmark;2022-08-03;M;173;0;8;6773;3222980;57297
Hovedstaden;2022-08-04;F;213;2;18;6775;3223193;57315
Midtjylland;2022-08-04;F;165;1;5;6776;3223358;57320
Nordjylland;2022-08-04;F;76;0;3;6776;3223434;57323
Sjælland;2022-08-04;F;152;0;6;6776;3223586;57329
Syddanmark;2022-08-04;F;141;0;3;6776;3223727;57332
Hovedstaden;2022-08-04;M;168;1;20;6777;3223895;57352
Midtjylland;2022-08-04;M;162;1;5;6778;3224057;57357
Nordjylland;2022-08-04;M;61;0;2;6778;3224118;57359
Sjælland;2022-08-04;M;109;1;8;6779;3224227;57367
Syddanmark;2022-08-04;M;112;1;7;6780;3224339;57374
Hovedstaden;2022-08-05;F;182;2;16;6782;3224521;57390
Midtjylland;2022-08-05;F;140;0;2;6782;3224661;57392
Nordjylland;2022-08-05;F;77;0;0;6782;3224738;57392
Sjælland;2022-08-05;F;121;1;7;6783;3224859;57399
Syddanmark;2022-08-05;F;157;1;5;6784;3225016;57404
Hovedstaden;2022-08-05;M;168;2;19;6786;3225184;57423
Midtjylland;2022-08-05;M;140;0;8;6786;3225324;57431
Nordjylland;2022-08-05;M;73;1;4;6787;3225397;57435
Sjælland;2022-08-05;M;102;1;14;6788;3225499;57449
Syddanmark;2022-08-05;M;147;1;9;6789;3225646;57458
Hovedstaden;2022-08-06;F;183;1;15;6790;3225829;57473
Midtjylland;2022-08-06;F;114;1;4;6791;3225943;57477
Nordjylland;2022-08-06;F;44;0;5;6791;3225987;57482
Sjælland;2022-08-06;F;80;1;3;6792;3226067;57485
Syddanmark;2022-08-06;F;77;0;3;6792;3226144;57488
Hovedstaden;2022-08-06;M;154;1;13;6793;3226298;57501
Midtjylland;2022-08-06;M;90;1;4;6794;3226388;57505
Nordjylland;2022-08-06;M;43;1;2;6795;3226431;57507
Sjælland;2022-08-06;M;64;0;5;6795;3226495;57512
Syddanmark;2022-08-06;M;79;1;5;6796;3226574;57517
Hovedstaden;2022-08-07;F;194;2;15;6798;3226768;57532
Midtjylland;2022-08-07;F;162;1;4;6799;3226930;57536
Nordjylland;2022-08-07;F;61;1;2;6800;3226991;57538
Sjælland;2022-08-07;F;90;0;3;6800;3227081;57541
Syddanmark;2022-08-07;F;165;0;8;6800;3227246;57549
Hovedstaden;2022-08-07;M;164;2;14;6802;3227410;57563
Midtjylland;2022-08-07;M;135;1;9;6803;3227545;57572
Nordjylland;2022-08-07;M;44;0;3;6803;3227589;57575
Sjælland;2022-08-07;M;89;0;4;6803;3227678;57579
Syddanmark;2022-08-07;M;130;1;8;6804;3227808;57587
Hovedstaden;2022-08-08;F;224;2;12;6806;3228032;57599
Midtjylland;2022-08-08;F;256;0;2;6806;3228288;57601
Nordjylland;2022-08-08;F;126;1;3;6807;3228414;57604
Sjælland;2022-08-08;F;165;1;9;6808;3228579;57613
Syddanmark;2022-08-08;F;247;1;11;6809;3228826;57624
Hovedstaden;2022-08-08;M;230;1;11;6810;3229056;57635
Midtjylland;2022-08-08;M;236;2;9;6812;3229292;57644
Nordjylland;2022-08-08;M;90;0;3;6812;3229382;57647
Sjælland;2022-08-08;M;145;1;7;6813;3229527;57654
Syddanmark;2022-08-08;M;243;0;6;6813;3229770;57660
Hovedstaden;2022-08-09;F;300;0;21;6813;3230070;57681
Midtjylland;2022-08-09;F;322;2;10;6815;3230392;57691
Nordjylland;2022-08-09;F;114;0;5;6815;3230506;57696
Sjælland;2022-08-09;F;167;2;10;6817;3230673;57706
Syddanmark;2022-08-09;F;265;1;5;6818;3230938;57711
Hovedstaden;2022-08-09;M;249;2;18;6820;3231187;57729
Midtjylland;2022-08-09;M;273;0;8;6820;3231460;57737
Nordjylland;2022-08-09;M;86;0;4;6820;3231546;57741
Sjælland;2022-08-09;M;141;0;4;6820;3231687;57745
Syddanmark;2022-08-09;M;220;1;11;6821;3231907;57756
Hovedstaden;2022-08-10;F;298;1;14;6822;3232205;57770
Midtjylland;2022-08-10;F;340;0;7;6822;3232545;57777
Nordjylland;2022-08-10;F;103;0;3;6822;3232648;57780
Sjælland;2022-08-10;F;195;0;9;6822;3232843;57789
Syddanmark;2022-08-10;F;217;2;10;6824;3233060;57799
Hovedstaden;2022-08-10;M;240;1;15;6825;3233300;57814
Midtjylland;2022-08-10;M;300;0;9;6825;3233600;57823
Nordjylland;2022-08-10;M;115;0;7;6825;3233715;57830
Sjælland;2022-08-10;M;150;1;4;6826;3233865;57834
Syddanmark;2022-08-10;M;186;2;8;6828;3234051;57842
Hovedstaden;2022-08-11;F;268;2;12;6830;3234319;57854
Midtjylland;2022-08-11;F;320;0;7;6830;3234639;57861
Nordjylland;2022-08-11;F;81;2;3;6832;3234720;57864
Sjælland;2022-08-11;F;132;0;7;6832;3234852;57871
Syddanmark;2022-08-11;F;162;1;6;6833;3235014;57877
Hovedstaden;2022-08-11;M;238;2;15;6835;3235252;57892
Midtjylland;2022-08-11;M;274;1;11;6836;3235526;57903
Nordjylland;2022-08-11;M;83;1;9;6837;3235609;57912
Sjælland;2022-08-11;M;128;1;7;6838;3235737;57919
Syddanmark;2022-08-11;M;142;0;5;6838;3235879;57924
Hovedstaden;2022-08-12;F;209;0;8;6838;3236088;57932
Midtjylland;2022-08-12;F;248;2;7;6840;3236336;57939
Nordjylland;2022-08-12;F;94;0;3;6840;3236430;57942
Sjælland;2022-08-12;F;138;0;3;6840;3236568;57945
Syddanmark;2022-08-12;F;179;2;10;6842;3236747;57955
Hovedstaden;2022-08-12;M;185;1;12;6843;3236932;57967
Midtjylland;2022-08-12;M;235;1;9;6844;3237167;57976
Nordjylland;2022-08-12;M;83;0;6;6844;3237250;57982
Sjælland;2022-08-12;M;120;1;7;6845;3237370;57989
Syddanmark;2022-08-12;M;171;1;12;6846;3237541;58001
Hovedstaden;2022-08-13;F;159;0;13;6846;3237700;58014
Midtjylland;2022-08-13;F;193;3;5;6849;3237893;58019
Nordjylland;2022-08-13;F;59;1;5;6850;3237952;58024
Sjælland;2022-08-13;F;80;1;5;6851;3238032;58029
Syddanmark;2022-08-13;F;98;3;8;6854;3238130;58037
Hovedstaden;2022-08-13;M;145;0;13;6854;3238275;58050
Midtjylland;2022-08-13;M;161;1;10;6855;3238436;58060
Nordjylland;2022-08-13;M;48;0;8;6855;3238484;58068
Sjælland;2022-08-13;M;62;1;6;6856;3238546;58074
Syddanmark;2022-08-13;M;81;1;6;6857;3238627;58080
Hovedstaden;2022-08-14;F;160;0;7;6857;3238787;58087
Midtjylland;2022-08-14;F;215;0;7;6857;3239002;58094
Nordjylland;2022-08-14;F;61;0;1;6857;3239063;58095
Sjælland;2022-08-14;F;97;0;6;6857;3239160;58101
Syddanmark;2022-08-14;F;127;2;10;6859;3239287;58111
Hovedstaden;2022-08-14;M;154;2;10;6861;3239441;58121
Midtjylland;2022-08-14;M;170;0;6;6861;3239611;58127
Nordjylland;2022-08-14;M;51;0;3;6861;3239662;58130
Sjælland;2022-08-14;M;108;1;10;6862;3239770;58140
Syddanmark;2022-08-14;M;126;0;9;6862;3239896;58149
Hovedstaden;2022-08-15;F;256;4;19;6866;3240152;58168
Midtjylland;2022-08-15;F;285;1;6;6867;3240437;58174
Nordjylland;2022-08-15;F;104;0;1;6867;3240541;58175
Sjælland;2022-08-15;F;150;0;14;6867;3240691;58189
Syddanmark;2022-08-15;F;219;0;6;6867;3240910;58195
Hovedstaden;2022-08-15;M;211;3;15;6870;3241121;58210
Midtjylland;2022-08-15;M;256;1;13;6871;3241377;58223
Nordjylland;2022-08-15;M;87;0;3;6871;3241464;58226
Sjælland;2022-08-15;M;136;1;12;6872;3241600;58238
Syddanmark;2022-08-15;M;211;0;10;6872;3241811;58248
Hovedstaden;2022-08-16;F;228;2;20;6874;3242039;58268
Midtjylland;2022-08-16;F;251;0;8;6874;3242290;58276
Nordjylland;2022-08-16;F;79;0;0;6874;3242369;58276
Sjælland;2022-08-16;F;128;1;6;6875;3242497;58282
Syddanmark;2022-08-16;F;188;0;10;6875;3242685;58292
Hovedstaden;2022-08-16;M;187;3;15;6878;3242872;58307
Midtjylland;2022-08-16;M;177;0;7;6878;3243049;58314
Nordjylland;2022-08-16;M;61;0;3;6878;3243110;58317
Sjælland;2022-08-16;M;123;0;13;6878;3243233;58330
Syddanmark;2022-08-16;M;188;1;10;6879;3243421;58340
Hovedstaden;2022-08-17;F;177;1;12;6880;3243598;58352
Midtjylland;2022-08-17;F;222;0;5;6880;3243820;58357
Nordjylland;2022-08-17;F;62;0;2;6880;3243882;58359
Sjælland;2022-08-17;F;149;0;7;6880;3244031;58366
Syddanmark;2022-08-17;F;178;1;6;6881;3244209;58372
Hovedstaden;2022-08-17;M;151;1;17;6882;3244360;58389
Midtjylland;2022-08-17;M;169;1;6;6883;3244529;58395
Nordjylland;2022-08-17;M;77;1;4;6884;3244606;58399
Sjælland;2022-08-17;M;116;0;3;6884;3244722;58402
Syddanmark;2022-08-17;M;144;1;8;6885;3244866;58410
Hovedstaden;2022-08-18;F;176;0;8;6885;3245042;58418
Midtjylland;2022-08-18;F;162;0;5;6885;3245204;58423
Nordjylland;2022-08-18;F;54;0;4;6885;3245258;58427
Sjælland;2022-08-18;F;114;1;7;6886;3245372;58434
Syddanmark;2022-08-18;F;137;0;6;6886;3245509;58440
Hovedstaden;2022-08-18;M;126;2;14;6888;3245635;58454
Midtjylland;2022-08-18;M;144;0;5;6888;3245779;58459
Nordjylland;2022-08-18;M;53;0;0;6888;3245832;58459
Sjælland;2022-08-18;M;101;1;9;6889;3245933;58468
Syddanmark;2022-08-18;M;103;0;6;6889;3246036;58474
Hovedstaden;2022-08-19;F;125;0;9;6889;3246161;58483
Midtjylland;2022-08-19;F;130;0;2;6889;3246291;58485
Nordjylland;2022-08-19;F;66;0;0;6889;3246357;58485
Sjælland;2022-08-19;F;126;1;12;6890;3246483;58497
Syddanmark;2022-08-19;F;127;1;7;6891;3246610;58504
Hovedstaden;2022-08-19;M;111;1;12;6892;3246721;58516
Midtjylland;2022-08-19;M;137;0;12;6892;3246858;58528
Nordjylland;2022-08-19;M;50;0;3;6892;3246908;58531
Sjælland;2022-08-19;M;95;2;8;6894;3247003;58539
Syddanmark;2022-08-19;M;98;2;2;6896;3247101;58541
Hovedstaden;2022-08-20;F;128;0;10;6896;3247229;58551
Midtjylland;2022-08-20;F;132;0;6;6896;3247361;58557
Nordjylland;2022-08-20;F;43;0;2;6896;3247404;58559
Sjælland;2022-08-20;F;30;1;3;6897;3247434;58562
Syddanmark;2022-08-20;F;56;1;4;6898;3247490;58566
Hovedstaden;2022-08-20;M;103;1;5;6899;3247593;58571
Midtjylland;2022-08-20;M;92;0;5;6899;3247685;58576
Nordjylland;2022-08-20;M;36;2;6;6901;3247721;58582
Sjælland;2022-08-20;M;39;1;5;6902;3247760;58587
Syddanmark;2022-08-20;M;45;2;4;6904;3247805;58591
Hovedstaden;2022-08-21;F;117;2;6;6906;3247922;58597
Midtjylland;2022-08-21;F;131;0;2;6906;3248053;58599
Nordjylland;2022-08-21;F;46;2;2;6908;3248099;58601
Sjælland;2022-08-21;F;65;1;4;6909;3248164;58605
Syddanmark;2022-08-21;F;108;0;6;6909;3248272;58611
Hovedstaden;2022-08-21;M;96;0;7;6909;3248368;58618
Midtjylland;2022-08-21;M;122;0;5;6909;3248490;58623
Nordjylland;2022-08-21;M;45;1;1;6910;3248535;58624
Sjælland;2022-08-21;M;60;0;4;6910;3248595;58628
Syddanmark;2022-08-21;M;90;1;6;6911;3248685;58634
Hovedstaden;2022-08-22;F;166;0;8;6911;3248851;58642
Midtjylland;2022-08-22;F;168;0;7;6911;3249019;58649
Nordjylland;2022-08-22;F;97;1;3;6912;3249116;58652
Sjælland;2022-08-22;F;64;0;1;6912;3249180;58653
Syddanmark;2022-08-22;F;136;0;4;6912;3249316;58657
Hovedstaden;2022-08-22;M;132;0;9;6912;3249448;58666
Midtjylland;2022-08-22;M;141;4;7;6916;3249589;58673
Nordjylland;2022-08-22;M;76;0;3;6916;3249665;58676
Sjælland;2022-08-22;M;60;1;5;6917;3249725;58681
Syddanmark;2022-08-22;M;129;1;3;6918;3249854;58684
Hovedstaden;2022-08-23;F;127;0;7;6918;3249981;58691
Midtjylland;2022-08-23;F;162;0;9;6918;3250143;58700
Nordjylland;2022-08-23;F;59;0;1;6918;3250202;58701
Sjælland;2022-08-23;F;103;0;5;6918;3250305;58706
Syddanmark;2022-08-23;F;130;1;5;6919;3250435;58711
Hovedstaden;2022-08-23;M;111;1;5;6920;3250546;58716
Midtjylland;2022-08-23;M;150;0;6;6920;3250696;58722
Nordjylland;2022-08-23;M;53;0;5;6920;3250749;58727
Sjælland;2022-08-23;M;71;2;5;6922;3250820;58732
Syddanmark;2022-08-23;M;101;1;4;6923;3250921;58736
Hovedstaden;2022-08-24;F;145;2;14;6925;3251066;58750
Midtjylland;2022-08-24;F;172;1;5;6926;3251238;58755
Nordjylland;2022-08-24;F;76;0;1;6926;3251314;58756
Sjælland;2022-08-24;F;99;0;7;6926;3251413;58763
Syddanmark;2022-08-24;F;112;0;5;6926;3251525;58768
Hovedstaden;2022-08-24;M;129;0;10;6926;3251654;58778
Midtjylland;2022-08-24;M;145;1;8;6927;3251799;58786
Nordjylland;2022-08-24;M;61;0;2;6927;3251860;58788
Sjælland;2022-08-24;M;85;0;6;6927;3251945;58794
Syddanmark;2022-08-24;M;109;1;8;6928;3252054;58802
Hovedstaden;2022-08-25;F;109;1;4;6929;3252163;58806
Midtjylland;2022-08-25;F;138;0;2;6929;3252301;58808
Nordjylland;2022-08-25;F;68;0;0;6929;3252369;58808
Sjælland;2022-08-25;F;89;1;2;6930;3252458;58810
Syddanmark;2022-08-25;F;83;1;3;6931;3252541;58813
Hovedstaden;2022-08-25;M;102;0;14;6931;3252643;58827
Midtjylland;2022-08-25;M;117;0;6;6931;3252760;58833
Nordjylland;2022-08-25;M;43;0;5;6931;3252803;58838
Sjælland;2022-08-25;M;73;0;8;6931;3252876;58846
Syddanmark;2022-08-25;M;60;0;9;6931;3252936;58855
Hovedstaden;2022-08-26;F;114;1;7;6932;3253050;58862
Midtjylland;2022-08-26;F;132;0;1;6932;3253182;58863
Nordjylland;2022-08-26;F;72;0;1;6932;3253254;58864
Sjælland;2022-08-26;F;79;1;8;6933;3253333;58872
Syddanmark;2022-08-26;F;98;0;9;6933;3253431;58881
Hovedstaden;2022-08-26;M;95;0;14;6933;3253526;58895
Midtjylland;2022-08-26;M;107;0;7;6933;3253633;58902
Nordjylland;2022-08-26;M;65;0;3;6933;3253698;58905
Sjælland;2022-08-26;M;55;0;4;6933;3253753;58909
Syddanmark;2022-08-26;M;75;0;5;6933;3253828;58914
Hovedstaden;2022-08-27;F;103;0;3;6933;3253931;58917
Midtjylland;2022-08-27;F;85;3;6;6936;3254016;58923
Nordjylland;2022-08-27;F;38;1;4;6937;3254054;58927
Sjælland;2022-08-27;F;33;0;2;6937;3254087;58929
Syddanmark;2022-08-27;F;46;1;6;6938;3254133;58935
Hovedstaden;2022-08-27;M;67;0;6;6938;3254200;58941
Midtjylland;2022-08-27;M;88;0;6;6938;3254288;58947
Nordjylland;2022-08-27;M;39;0;2;6938;3254327;58949
Sjælland;2022-08-27;M;30;0;2;6938;3254357;58951
Syddanmark;2022-08-27;M;46;2;7;6940;3254403;58958
Hovedstaden;2022-08-28;F;81;1;10;6941;3254484;58968
Midtjylland;2022-08-28;F;97;0;0;6941;3254581;58968
Nordjylland;2022-08-28;F;40;0;1;6941;3254621;58969
Sjælland;2022-08-28;F;52;1;5;6942;3254673;58974
Syddanmark;2022-08-28;F;74;1;3;6943;3254747;58977
Hovedstaden;2022-08-28;M;70;0;4;6943;3254817;58981
Midtjylland;2022-08-28;M;77;0;3;6943;3254894;58984
Nordjylland;2022-08-28;M;34;0;3;6943;3254928;58987
Sjælland;2022-08-28;M;48;0;3;6943;3254976;58990
Syddanmark;2022-08-28;M;65;0;5;6943;3255041;58995
Hovedstaden;2022-08-29;F;137;0;5;6943;3255178;59000
Midtjylland;2022-08-29;F;120;3;6;6946;3255298;59006
Nordjylland;2022-08-29;F;68;1;3;6947;3255366;59009
Sjælland;2022-08-29;F;81;0;5;6947;3255447;59014
Syddanmark;2022-08-29;F;125;0;6;6947;3255572;59020
Hovedstaden;2022-08-29;M;133;1;10;6948;3255705;59030
Midtjylland;2022-08-29;M;101;0;5;6948;3255806;59035
Nordjylland;2022-08-29;M;58;0;4;6948;3255864;59039
Sjælland;2022-08-29;M;71;0;1;6948;3255935;59040
Syddanmark;2022-08-29;M;103;0;3;6948;3256038;59043
Hovedstaden;2022-08-30;F;84;1;7;6949;3256122;59050
Midtjylland;2022-08-30;F;119;1;6;6950;3256241;59056
Nordjylland;2022-08-30;F;36;0;1;6950;3256277;59057
Sjælland;2022-08-30;F;59;0;3;6950;3256336;59060
Syddanmark;2022-08-30;F;103;0;2;6950;3256439;59062
Hovedstaden;2022-08-30;M;83;1;8;6951;3256522;59070
Midtjylland;2022-08-30;M;92;0;4;6951;3256614;59074
Nordjylland;2022-08-30;M;41;0;3;6951;3256655;59077
Sjælland;2022-08-30;M;52;0;2;6951;3256707;59079
Syddanmark;2022-08-30;M;79;0;1;6951;3256786;59080
Hovedstaden;2022-08-31;F;108;0;4;6951;3256894;59084
Midtjylland;2022-08-31;F;126;0;5;6951;3257020;59089
Nordjylland;2022-08-31;F;51;1;2;6952;3257071;59091
Sjælland;2022-08-31;F;66;0;3;6952;3257137;59094
Syddanmark;2022-08-31;F;62;0;4;6952;3257199;59098
Hovedstaden;2022-08-31;M;95;0;1;6952;3257294;59099
Midtjylland;2022-08-31;M;109;2;7;6954;3257403;59106
Nordjylland;2022-08-31;M;38;0;2;6954;3257441;59108
Sjælland;2022-08-31;M;65;0;3;6954;3257506;59111
Syddanmark;2022-08-31;M;56;0;8;6954;3257562;59119
Hovedstaden;2022-09-01;F;91;1;6;6955;3257653;59125
Midtjylland;2022-09-01;F;104;1;5;6956;3257757;59130
Nordjylland;2022-09-01;F;32;0;2;6956;3257789;59132
Sjælland;2022-09-01;F;62;0;5;6956;3257851;59137
Syddanmark;2022-09-01;F;77;1;9;6957;3257928;59146
Hovedstaden;2022-09-01;M;74;0;6;6957;3258002;59152
Midtjylland;2022-09-01;M;92;0;7;6957;3258094;59159
Nordjylland;2022-09-01;M;24;0;6;6957;3258118;59165
Sjælland;2022-09-01;M;62;1;4;6958;3258180;59169
Syddanmark;2022-09-01;M;51;0;3;6958;3258231;59172
Hovedstaden;2022-09-02;F;105;0;8;6958;3258336;59180
Midtjylland;2022-09-02;F;100;0;5;6958;3258436;59185
Nordjylland;2022-09-02;F;31;0;2;6958;3258467;59187
Sjælland;2022-09-02;F;55;0;5;6958;3258522;59192
Syddanmark;2022-09-02;F;78;1;4;6959;3258600;59196
Hovedstaden;2022-09-02;M;105;0;8;6959;3258705;59204
Midtjylland;2022-09-02;M;79;0;6;6959;3258784;59210
Nordjylland;2022-09-02;M;32;2;3;6961;3258816;59213
Sjælland;2022-09-02;M;39;1;3;6962;3258855;59216
Syddanmark;2022-09-02;M;71;0;6;6962;3258926;59222
Hovedstaden;2022-09-03;F;92;0;6;6962;3259018;59228
Midtjylland;2022-09-03;F;70;0;2;6962;3259088;59230
Nordjylland;2022-09-03;F;26;0;3;6962;3259114;59233
Sjælland;2022-09-03;F;24;0;2;6962;3259138;59235
Syddanmark;2022-09-03;F;36;0;1;6962;3259174;59236
Hovedstaden;2022-09-03;M;78;0;6;6962;3259252;59242
Midtjylland;2022-09-03;M;64;0;3;6962;3259316;59245
Nordjylland;2022-09-03;M;14;0;1;6962;3259330;59246
Sjælland;2022-09-03;M;23;0;3;6962;3259353;59249
Syddanmark;2022-09-03;M;37;0;6;6962;3259390;59255
Hovedstaden;2022-09-04;F;96;1;8;6963;3259486;59263
Midtjylland;2022-09-04;F;84;0;3;6963;3259570;59266
Nordjylland;2022-09-04;F;30;0;1;6963;3259600;59267
Sjælland;2022-09-04;F;46;0;5;6963;3259646;59272
Syddanmark;2022-09-04;F;39;1;2;6964;3259685;59274
Hovedstaden;2022-09-04;M;72;1;6;6965;3259757;59280
Midtjylland;2022-09-04;M;70;0;2;6965;3259827;59282
Nordjylland;2022-09-04;M;23;0;3;6965;3259850;59285
Sjælland;2022-09-04;M;50;0;2;6965;3259900;59287
Syddanmark;2022-09-04;M;43;0;5;6965;3259943;59292
Hovedstaden;2022-09-05;F;146;0;15;6965;3260089;59307
Midtjylland;2022-09-05;F;136;0;3;6965;3260225;59310
Nordjylland;2022-09-05;F;63;0;7;6965;3260288;59317
Sjælland;2022-09-05;F;92;0;3;6965;3260380;59320
Syddanmark;2022-09-05;F;137;0;2;6965;3260517;59322
Hovedstaden;2022-09-05;M;108;0;9;6965;3260625;59331
Midtjylland;2022-09-05;M;115;1;4;6966;3260740;59335
Nordjylland;2022-09-05;M;38;0;1;6966;3260778;59336
Sjælland;2022-09-05;M;91;0;3;6966;3260869;59339
Syddanmark;2022-09-05;M;126;0;10;6966;3260995;59349
Hovedstaden;2022-09-06;F;147;0;11;6966;3261142;59360
Midtjylland;2022-09-06;F;114;0;4;6966;3261256;59364
Nordjylland;2022-09-06;F;48;1;4;6967;3261304;59368
Sjælland;2022-09-06;F;68;0;5;6967;3261372;59373
Syddanmark;2022-09-06;F;106;0;6;6967;3261478;59379
Hovedstaden;2022-09-06;M;101;1;7;6968;3261579;59386
Midtjylland;2022-09-06;M;85;0;2;6968;3261664;59388
Nordjylland;2022-09-06;M;40;0;4;6968;3261704;59392
Sjælland;2022-09-06;M;62;0;2;6968;3261766;59394
Syddanmark;2022-09-06;M;94;2;3;6970;3261860;59397
Hovedstaden;2022-09-07;F;129;0;14;6970;3261989;59411
Midtjylland;2022-09-07;F;120;0;2;6970;3262109;59413
Nordjylland;2022-09-07;F;46;0;3;6970;3262155;59416
Sjælland;2022-09-07;F;79;1;6;6971;3262234;59422
Syddanmark;2022-09-07;F;90;1;2;6972;3262324;59424
Hovedstaden;2022-09-07;M;125;0;15;6972;3262449;59439
Midtjylland;2022-09-07;M;101;0;3;6972;3262550;59442
Nordjylland;2022-09-07;M;38;1;3;6973;3262588;59445
Sjælland;2022-09-07;M;63;0;1;6973;3262651;59446
Syddanmark;2022-09-07;M;87;0;7;6973;3262738;59453
Hovedstaden;2022-09-08;F;134;0;5;6973;3262872;59458
Midtjylland;2022-09-08;F;107;0;4;6973;3262979;59462
Nordjylland;2022-09-08;F;45;1;1;6974;3263024;59463
Sjælland;2022-09-08;F;89;0;1;6974;3263113;59464
Syddanmark;2022-09-08;F;75;0;6;6974;3263188;59470
Hovedstaden;2022-09-08;M;117;1;11;6975;3263305;59481
Midtjylland;2022-09-08;M;84;1;9;6976;3263389;59490
Nordjylland;2022-09-08;M;45;0;5;6976;3263434;59495
Sjælland;2022-09-08;M;69;0;4;6976;3263503;59499
Syddanmark;2022-09-08;M;62;0;2;6976;3263565;59501
Hovedstaden;2022-09-09;F;107;1;6;6977;3263672;59507
Midtjylland;2022-09-09;F;82;0;5;6977;3263754;59512
Nordjylland;2022-09-09;F;43;0;2;6977;3263797;59514
Sjælland;2022-09-09;F;74;0;1;6977;3263871;59515
Syddanmark;2022-09-09;F;65;0;1;6977;3263936;59516
Hovedstaden;2022-09-09;M;99;0;15;6977;3264035;59531
Midtjylland;2022-09-09;M;63;1;10;6978;3264098;59541
Nordjylland;2022-09-09;M;39;0;3;6978;3264137;59544
Sjælland;2022-09-09;M;43;1;5;6979;3264180;59549
Syddanmark;2022-09-09;M;52;0;4;6979;3264232;59553
Hovedstaden;2022-09-10;F;79;1;7;6980;3264311;59560
Midtjylland;2022-09-10;F;76;0;2;6980;3264387;59562
Nordjylland;2022-09-10;F;25;0;3;6980;3264412;59565
Sjælland;2022-09-10;F;29;0;2;6980;3264441;59567
Syddanmark;2022-09-10;F;41;0;1;6980;3264482;59568
Hovedstaden;2022-09-10;M;73;0;6;6980;3264555;59574
Midtjylland;2022-09-10;M;65;0;1;6980;3264620;59575
Nordjylland;2022-09-10;M;27;1;2;6981;3264647;59577
Sjælland;2022-09-10;M;37;0;4;6981;3264684;59581
Syddanmark;2022-09-10;M;40;0;2;6981;3264724;59583
Hovedstaden;2022-09-11;F;100;0;9;6981;3264824;59592
Midtjylland;2022-09-11;F;78;0;7;6981;3264902;59599
Nordjylland;2022-09-11;F;34;1;2;6982;3264936;59601
Sjælland;2022-09-11;F;41;0;3;6982;3264977;59604
Syddanmark;2022-09-11;F;73;0;3;6982;3265050;59607
Hovedstaden;2022-09-11;M;86;1;9;6983;3265136;59616
Midtjylland;2022-09-11;M;63;0;4;6983;3265199;59620
Nordjylland;2022-09-11;M;27;0;1;6983;3265226;59621
Sjælland;2022-09-11;M;38;0;1;6983;3265264;59622
Syddanmark;2022-09-11;M;72;1;2;6984;3265336;59624
Hovedstaden;2022-09-12;F;166;2;11;6986;3265502;59635
Midtjylland;2022-09-12;F;111;1;4;6987;3265613;59639
Nordjylland;2022-09-12;F;72;1;4;6988;3265685;59643
Sjælland;2022-09-12;F;111;0;4;6988;3265796;59647
Syddanmark;2022-09-12;F;123;1;3;6989;3265919;59650
Hovedstaden;2022-09-12;M;117;0;10;6989;3266036;59660
Midtjylland;2022-09-12;M;90;0;4;6989;3266126;59664
Nordjylland;2022-09-12;M;47;0;4;6989;3266173;59668
Sjælland;2022-09-12;M;76;0;6;6989;3266249;59674
Syddanmark;2022-09-12;M;89;0;3;6989;3266338;59677
Hovedstaden;2022-09-13;F;120;1;9;6990;3266458;59686
Midtjylland;2022-09-13;F;99;0;5;6990;3266557;59691
Nordjylland;2022-09-13;F;54;0;2;6990;3266611;59693
Sjælland;2022-09-13;F;88;0;7;6990;3266699;59700
Syddanmark;2022-09-13;F;113;0;5;6990;3266812;59705
Hovedstaden;2022-09-13;M;117;2;10;6992;3266929;59715
Midtjylland;2022-09-13;M;77;0;5;6992;3267006;59720
Nordjylland;2022-09-13;M;46;0;4;6992;3267052;59724
Sjælland;2022-09-13;M;70;1;5;6993;3267122;59729
Syddanmark;2022-09-13;M;108;1;7;6994;3267230;59736
Hovedstaden;2022-09-14;F;124;2;13;6996;3267354;59749
Midtjylland;2022-09-14;F;77;0;2;6996;3267431;59751
Nordjylland;2022-09-14;F;64;0;3;6996;3267495;59754
Sjælland;2022-09-14;F;77;0;1;6996;3267572;59755
Syddanmark;2022-09-14;F;86;1;4;6997;3267658;59759
Hovedstaden;2022-09-14;M;99;1;6;6998;3267757;59765
Midtjylland;2022-09-14;M;74;0;5;6998;3267831;59770
Nordjylland;2022-09-14;M;47;0;3;6998;3267878;59773
Sjælland;2022-09-14;M;86;0;6;6998;3267964;59779
Syddanmark;2022-09-14;M;76;1;3;6999;3268040;59782
Hovedstaden;2022-09-15;F;135;1;6;7000;3268175;59788
Midtjylland;2022-09-15;F;67;0;4;7000;3268242;59792
Nordjylland;2022-09-15;F;59;0;6;7000;3268301;59798
Sjælland;2022-09-15;F;89;1;4;7001;3268390;59802
Syddanmark;2022-09-15;F;99;1;4;7002;3268489;59806
Hovedstaden;2022-09-15;M;102;1;7;7003;3268591;59813
Midtjylland;2022-09-15;M;59;1;3;7004;3268650;59816
Nordjylland;2022-09-15;M;35;0;3;7004;3268685;59819
Sjælland;2022-09-15;M;75;0;4;7004;3268760;59823
Syddanmark;2022-09-15;M;83;0;7;7004;3268843;59830
Hovedstaden;2022-09-16;F;115;0;13;7004;3268958;59843
Midtjylland;2022-09-16;F;79;0;1;7004;3269037;59844
Nordjylland;2022-09-16;F;55;0;2;7004;3269092;59846
Sjælland;2022-09-16;F;64;0;0;7004;3269156;59846
Syddanmark;2022-09-16;F;73;0;5;7004;3269229;59851
Hovedstaden;2022-09-16;M;83;0;7;7004;3269312;59858
Midtjylland;2022-09-16;M;74;2;5;7006;3269386;59863
Nordjylland;2022-09-16;M;50;0;1;7006;3269436;59864
Sjælland;2022-09-16;M;44;2;1;7008;3269480;59865
Syddanmark;2022-09-16;M;58;1;3;7009;3269538;59868
Hovedstaden;2022-09-17;F;87;0;5;7009;3269625;59873
Midtjylland;2022-09-17;F;55;0;2;7009;3269680;59875
Nordjylland;2022-09-17;F;34;0;1;7009;3269714;59876
Sjælland;2022-09-17;F;33;0;4;7009;3269747;59880
Syddanmark;2022-09-17;F;38;1;7;7010;3269785;59887
Hovedstaden;2022-09-17;M;66;0;6;7010;3269851;59893
Midtjylland;2022-09-17;M;49;1;3;7011;3269900;59896
Nordjylland;2022-09-17;M;23;1;2;7012;3269923;59898
Sjælland;2022-09-17;M;21;1;2;7013;3269944;59900
Syddanmark;2022-09-17;M;18;1;5;7014;3269962;59905
Hovedstaden;2022-09-18;F;78;0;3;7014;3270040;59908
Midtjylland;2022-09-18;F;84;0;7;7014;3270124;59915
Nordjylland;2022-09-18;F;21;0;4;7014;3270145;59919
Sjælland;2022-09-18;F;48;0;5;7014;3270193;59924
Syddanmark;2022-09-18;F;70;0;3;7014;3270263;59927
Hovedstaden;2022-09-18;M;79;3;15;7017;3270342;59942
Midtjylland;2022-09-18;M;72;0;5;7017;3270414;59947
Nordjylland;2022-09-18;M;15;0;3;7017;3270429;59950
Sjælland;2022-09-18;M;51;1;4;7018;3270480;59954
Syddanmark;2022-09-18;M;74;0;6;7018;3270554;59960
Hovedstaden;2022-09-19;F;142;2;7;7020;3270696;59967
Midtjylland;2022-09-19;F;112;0;5;7020;3270808;59972
Nordjylland;2022-09-19;F;65;1;2;7021;3270873;59974
Sjælland;2022-09-19;F;101;1;11;7022;3270974;59985
Syddanmark;2022-09-19;F;126;1;5;7023;3271100;59990
Hovedstaden;2022-09-19;M;120;3;14;7026;3271220;60004
Midtjylland;2022-09-19;M;123;2;10;7028;3271343;60014
Nordjylland;2022-09-19;M;59;3;6;7031;3271402;60020
Sjælland;2022-09-19;M;87;3;7;7034;3271489;60027
Syddanmark;2022-09-19;M;118;0;5;7034;3271607;60032
Hovedstaden;2022-09-20;F;139;0;10;7034;3271746;60042
Midtjylland;2022-09-20;F;116;0;8;7034;3271862;60050
Nordjylland;2022-09-20;F;44;0;0;7034;3271906;60050
Sjælland;2022-09-20;F;116;0;10;7034;3272022;60060
Syddanmark;2022-09-20;F;134;4;9;7038;3272156;60069
Hovedstaden;2022-09-20;M;106;1;10;7039;3272262;60079
Midtjylland;2022-09-20;M;103;0;4;7039;3272365;60083
Nordjylland;2022-09-20;M;39;0;4;7039;3272404;60087
Sjælland;2022-09-20;M;87;0;3;7039;3272491;60090
Syddanmark;2022-09-20;M;111;1;6;7040;3272602;60096
Hovedstaden;2022-09-21;F;157;1;10;7041;3272759;60106
Midtjylland;2022-09-21;F;142;2;7;7043;3272901;60113
Nordjylland;2022-09-21;F;57;0;0;7043;3272958;60113
Sjælland;2022-09-21;F;130;0;8;7043;3273088;60121
Syddanmark;2022-09-21;F;146;2;7;7045;3273234;60128
Hovedstaden;2022-09-21;M;121;0;15;7045;3273355;60143
Midtjylland;2022-09-21;M;113;1;8;7046;3273468;60151
Nordjylland;2022-09-21;M;55;1;5;7047;3273523;60156
Sjælland;2022-09-21;M;96;2;10;7049;3273619;60166
Syddanmark;2022-09-21;M;91;1;5;7050;3273710;60171
Hovedstaden;2022-09-22;F;174;4;7;7054;3273884;60178
Midtjylland;2022-09-22;F;126;1;7;7055;3274010;60185
Nordjylland;2022-09-22;F;64;2;3;7057;3274074;60188
Sjælland;2022-09-22;F;116;0;6;7057;3274190;60194
Syddanmark;2022-09-22;F;115;0;2;7057;3274305;60196
Hovedstaden;2022-09-22;M;131;2;8;7059;3274436;60204
Midtjylland;2022-09-22;M;108;4;8;7063;3274544;60212
Nordjylland;2022-09-22;M;48;1;4;7064;3274592;60216
Sjælland;2022-09-22;M;107;2;7;7066;3274699;60223
Syddanmark;2022-09-22;M;110;0;8;7066;3274809;60231
Hovedstaden;2022-09-23;F;153;0;10;7066;3274962;60241
Midtjylland;2022-09-23;F;115;0;6;7066;3275077;60247
Nordjylland;2022-09-23;F;52;0;6;7066;3275129;60253
Sjælland;2022-09-23;F;111;0;4;7066;3275240;60257
Syddanmark;2022-09-23;F;103;2;7;7068;3275343;60264
Hovedstaden;2022-09-23;M;136;6;20;7074;3275479;60284
Midtjylland;2022-09-23;M;113;1;5;7075;3275592;60289
Nordjylland;2022-09-23;M;49;0;9;7075;3275641;60298
Sjælland;2022-09-23;M;76;1;4;7076;3275717;60302
Syddanmark;2022-09-23;M;83;0;6;7076;3275800;60308
Hovedstaden;2022-09-24;F;115;0;13;7076;3275915;60321
Midtjylland;2022-09-24;F;91;1;3;7077;3276006;60324
Nordjylland;2022-09-24;F;43;2;1;7079;3276049;60325
Sjælland;2022-09-24;F;41;0;3;7079;3276090;60328
Syddanmark;2022-09-24;F;75;2;3;7081;3276165;60331
Hovedstaden;2022-09-24;M;110;0;7;7081;3276275;60338
Midtjylland;2022-09-24;M;94;0;9;7081;3276369;60347
Nordjylland;2022-09-24;M;29;2;5;7083;3276398;60352
Sjælland;2022-09-24;M;45;1;6;7084;3276443;60358
Syddanmark;2022-09-24;M;61;2;6;7086;3276504;60364
Hovedstaden;2022-09-25;F;176;1;20;7087;3276680;60384
Midtjylland;2022-09-25;F;121;0;10;7087;3276801;60394
Nordjylland;2022-09-25;F;43;1;3;7088;3276844;60397
Sjælland;2022-09-25;F;79;0;8;7088;3276923;60405
Syddanmark;2022-09-25;F;125;1;3;7089;3277048;60408
Hovedstaden;2022-09-25;M;136;0;9;7089;3277184;60417
Midtjylland;2022-09-25;M;95;1;5;7090;3277279;60422
Nordjylland;2022-09-25;M;29;0;3;7090;3277308;60425
Sjælland;2022-09-25;M;56;1;6;7091;3277364;60431
Syddanmark;2022-09-25;M;118;1;8;7092;3277482;60439
Hovedstaden;2022-09-26;F;237;2;14;7094;3277719;60453
Midtjylland;2022-09-26;F;188;0;9;7094;3277907;60462
Nordjylland;2022-09-26;F;81;1;4;7095;3277988;60466
Sjælland;2022-09-26;F;148;0;7;7095;3278136;60473
Syddanmark;2022-09-26;F;193;1;11;7096;3278329;60484
Hovedstaden;2022-09-26;M;188;0;19;7096;3278517;60503
Midtjylland;2022-09-26;M;158;0;7;7096;3278675;60510
Nordjylland;2022-09-26;M;69;0;4;7096;3278744;60514
Sjælland;2022-09-26;M;134;0;8;7096;3278878;60522
Syddanmark;2022-09-26;M;177;3;10;7099;3279055;60532
Hovedstaden;2022-09-27;F;207;1;19;7100;3279262;60551
Midtjylland;2022-09-27;F;152;0;9;7100;3279414;60560
Nordjylland;2022-09-27;F;56;2;7;7102;3279470;60567
Sjælland;2022-09-27;F;146;1;9;7103;3279616;60576
Syddanmark;2022-09-27;F;193;3;8;7106;3279809;60584
Hovedstaden;2022-09-27;M;156;2;9;7108;3279965;60593
Midtjylland;2022-09-27;M;150;2;11;7110;3280115;60604
Nordjylland;2022-09-27;M;42;0;5;7110;3280157;60609
Sjælland;2022-09-27;M;152;1;10;7111;3280309;60619
Syddanmark;2022-09-27;M;178;2;7;7113;3280487;60626
Hovedstaden;2022-09-28;F;161;1;15;7114;3280648;60641
Midtjylland;2022-09-28;F;155;0;4;7114;3280803;60645
Nordjylland;2022-09-28;F;72;1;4;7115;3280875;60649
Sjælland;2022-09-28;F;107;0;3;7115;3280982;60652
Syddanmark;2022-09-28;F;174;1;7;7116;3281156;60659
Hovedstaden;2022-09-28;M;153;1;14;7117;3281309;60673
Midtjylland;2022-09-28;M;137;0;7;7117;3281446;60680
Nordjylland;2022-09-28;M;66;0;3;7117;3281512;60683
Sjælland;2022-09-28;M;88;0;6;7117;3281600;60689
Syddanmark;2022-09-28;M;147;1;15;7118;3281747;60704
Hovedstaden;2022-09-29;F;180;1;9;7119;3281927;60713
Midtjylland;2022-09-29;F;136;0;4;7119;3282063;60717
Nordjylland;2022-09-29;F;63;0;3;7119;3282126;60720
Sjælland;2022-09-29;F;134;0;12;7119;3282260;60732
Syddanmark;2022-09-29;F;141;1;2;7120;3282401;60734
Hovedstaden;2022-09-29;M;165;1;17;7121;3282566;60751
Midtjylland;2022-09-29;M;136;2;7;7123;3282702;60758
Nordjylland;2022-09-29;M;52;1;4;7124;3282754;60762
Sjælland;2022-09-29;M;114;1;13;7125;3282868;60775
Syddanmark;2022-09-29;M;145;1;10;7126;3283013;60785
Hovedstaden;2022-09-30;F;160;1;11;7127;3283173;60796
Midtjylland;2022-09-30;F;120;0;6;7127;3283293;60802
Nordjylland;2022-09-30;F;67;0;5;7127;3283360;60807
Sjælland;2022-09-30;F;112;0;10;7127;3283472;60817
Syddanmark;2022-09-30;F;136;1;8;7128;3283608;60825
Hovedstaden;2022-09-30;M;135;2;19;7130;3283743;60844
Midtjylland;2022-09-30;M;107;0;6;7130;3283850;60850
Nordjylland;2022-09-30;M;69;1;7;7131;3283919;60857
Sjælland;2022-09-30;M;87;0;8;7131;3284006;60865
Syddanmark;2022-09-30;M;107;3;6;7134;3284113;60871
Hovedstaden;2022-10-01;F;129;0;13;7134;3284242;60884
Midtjylland;2022-10-01;F;134;1;4;7135;3284376;60888
Nordjylland;2022-10-01;F;36;0;3;7135;3284412;60891
Sjælland;2022-10-01;F;58;0;7;7135;3284470;60898
Syddanmark;2022-10-01;F;93;1;12;7136;3284563;60910
Hovedstaden;2022-10-01;M;106;1;4;7137;3284669;60914
Midtjylland;2022-10-01;M;101;1;7;7138;3284770;60921
Nordjylland;2022-10-01;M;36;1;3;7139;3284806;60924
Sjælland;2022-10-01;M;48;0;6;7139;3284854;60930
Syddanmark;2022-10-01;M;96;1;9;7140;3284950;60939
Hovedstaden;2022-10-02;F;134;0;9;7140;3285084;60948
Midtjylland;2022-10-02;F;115;0;4;7140;3285199;60952
Nordjylland;2022-10-02;F;41;0;1;7140;3285240;60953
Sjælland;2022-10-02;F;64;2;6;7142;3285304;60959
Syddanmark;2022-10-02;F;166;0;8;7142;3285470;60967
Hovedstaden;2022-10-02;M;126;3;16;7145;3285596;60983
Midtjylland;2022-10-02;M;123;0;7;7145;3285719;60990
Nordjylland;2022-10-02;M;32;0;2;7145;3285751;60992
Sjælland;2022-10-02;M;67;1;15;7146;3285818;61007
Syddanmark;2022-10-02;M;137;1;7;7147;3285955;61014
Hovedstaden;2022-10-03;F;224;1;13;7148;3286179;61027
Midtjylland;2022-10-03;F;180;1;7;7149;3286359;61034
Nordjylland;2022-10-03;F;91;0;2;7149;3286450;61036
Sjælland;2022-10-03;F;184;2;16;7151;3286634;61052
Syddanmark;2022-10-03;F;262;4;13;7155;3286896;61065
Hovedstaden;2022-10-03;M;185;0;14;7155;3287081;61079
Midtjylland;2022-10-03;M;153;1;7;7156;3287234;61086
Nordjylland;2022-10-03;M;91;1;11;7157;3287325;61097
Sjælland;2022-10-03;M;149;2;11;7159;3287474;61108
Syddanmark;2022-10-03;M;229;4;11;7163;3287703;61119
Hovedstaden;2022-10-04;F;199;2;21;7165;3287902;61140
Midtjylland;2022-10-04;F;184;0;9;7165;3288086;61149
Nordjylland;2022-10-04;F;67;0;6;7165;3288153;61155
Sjælland;2022-10-04;F;150;1;13;7166;3288303;61168
Syddanmark;2022-10-04;F;233;0;10;7166;3288536;61178
Hovedstaden;2022-10-04;M;182;2;15;7168;3288718;61193
Midtjylland;2022-10-04;M;173;0;10;7168;3288891;61203
Nordjylland;2022-10-04;M;60;2;5;7170;3288951;61208
Sjælland;2022-10-04;M;124;0;15;7170;3289075;61223
Syddanmark;2022-10-04;M;193;0;5;7170;3289268;61228
Hovedstaden;2022-10-05;F;229;0;19;7170;3289497;61247
Midtjylland;2022-10-05;F;192;0;6;7170;3289689;61253
Nordjylland;2022-10-05;F;85;0;5;7170;3289774;61258
Sjælland;2022-10-05;F;140;1;14;7171;3289914;61272
Syddanmark;2022-10-05;F;223;0;6;7171;3290137;61278
Hovedstaden;2022-10-05;M;159;1;13;7172;3290296;61291
Midtjylland;2022-10-05;M;144;0;11;7172;3290440;61302
Nordjylland;2022-10-05;M;50;1;2;7173;3290490;61304
Sjælland;2022-10-05;M;113;0;11;7173;3290603;61315
Syddanmark;2022-10-05;M;194;1;8;7174;3290797;61323
Hovedstaden;2022-10-06;F;162;0;9;7174;3290959;61332
Midtjylland;2022-10-06;F;180;0;3;7174;3291139;61335
Nordjylland;2022-10-06;F;60;0;1;7174;3291199;61336
Sjælland;2022-10-06;F;119;3;11;7177;3291318;61347
Syddanmark;2022-10-06;F;168;1;5;7178;3291486;61352
Hovedstaden;2022-10-06;M;151;0;19;7178;3291637;61371
Midtjylland;2022-10-06;M;159;1;7;7179;3291796;61378
Nordjylland;2022-10-06;M;51;1;4;7180;3291847;61382
Sjælland;2022-10-06;M;107;2;13;7182;3291954;61395
Syddanmark;2022-10-06;M;145;0;10;7182;3292099;61405
Hovedstaden;2022-10-07;F;141;3;13;7185;3292240;61418
Midtjylland;2022-10-07;F;157;0;6;7185;3292397;61424
Nordjylland;2022-10-07;F;66;1;3;7186;3292463;61427
Sjælland;2022-10-07;F;118;1;10;7187;3292581;61437
Syddanmark;2022-10-07;F;170;0;10;7187;3292751;61447
Hovedstaden;2022-10-07;M;164;1;15;7188;3292915;61462
Midtjylland;2022-10-07;M;136;1;16;7189;3293051;61478
Nordjylland;2022-10-07;M;68;0;5;7189;3293119;61483
Sjælland;2022-10-07;M;96;0;11;7189;3293215;61494
Syddanmark;2022-10-07;M;143;1;13;7190;3293358;61507
Hovedstaden;2022-10-08;F;132;1;18;7191;3293490;61525
Midtjylland;2022-10-08;F;121;0;5;7191;3293611;61530
Nordjylland;2022-10-08;F;49;1;3;7192;3293660;61533
Sjælland;2022-10-08;F;91;1;10;7193;3293751;61543
Syddanmark;2022-10-08;F;82;0;8;7193;3293833;61551
Hovedstaden;2022-10-08;M;102;1;10;7194;3293935;61561
Midtjylland;2022-10-08;M;135;0;8;7194;3294070;61569
Nordjylland;2022-10-08;M;37;0;2;7194;3294107;61571
Sjælland;2022-10-08;M;63;0;7;7194;3294170;61578
Syddanmark;2022-10-08;M;97;0;11;7194;3294267;61589
Hovedstaden;2022-10-09;F;128;0;16;7194;3294395;61605
Midtjylland;2022-10-09;F;161;0;6;7194;3294556;61611
Nordjylland;2022-10-09;F;50;0;3;7194;3294606;61614
Sjælland;2022-10-09;F;109;2;9;7196;3294715;61623
Syddanmark;2022-10-09;F;197;1;7;7197;3294912;61630
Hovedstaden;2022-10-09;M;130;1;11;7198;3295042;61641
Midtjylland;2022-10-09;M;124;1;5;7199;3295166;61646
Nordjylland;2022-10-09;M;39;1;2;7200;3295205;61648
Sjælland;2022-10-09;M;97;3;14;7203;3295302;61662
Syddanmark;2022-10-09;M;133;2;10;7205;3295435;61672
Hovedstaden;2022-10-10;F;198;2;25;7207;3295633;61697
Midtjylland;2022-10-10;F;200;0;10;7207;3295833;61707
Nordjylland;2022-10-10;F;110;0;6;7207;3295943;61713
Sjælland;2022-10-10;F;156;2;14;7209;3296099;61727
Syddanmark;2022-10-10;F;207;1;10;7210;3296306;61737
Hovedstaden;2022-10-10;M;170;1;17;7211;3296476;61754
Midtjylland;2022-10-10;M;187;1;10;7212;3296663;61764
Nordjylland;2022-10-10;M;82;2;8;7214;3296745;61772
Sjælland;2022-10-10;M;128;6;16;7220;3296873;61788
Syddanmark;2022-10-10;M;192;2;16;7222;3297065;61804
Hovedstaden;2022-10-11;F;185;1;18;7223;3297250;61822
Midtjylland;2022-10-11;F;186;2;13;7225;3297436;61835
Nordjylland;2022-10-11;F;75;1;6;7226;3297511;61841
Sjælland;2022-10-11;F;129;3;11;7229;3297640;61852
Syddanmark;2022-10-11;F;203;1;9;7230;3297843;61861
Hovedstaden;2022-10-11;M;173;2;16;7232;3298016;61877
Midtjylland;2022-10-11;M;150;0;14;7232;3298166;61891
Nordjylland;2022-10-11;M;53;0;5;7232;3298219;61896
Sjælland;2022-10-11;M;137;0;19;7232;3298356;61915
Syddanmark;2022-10-11;M;178;3;18;7235;3298534;61933
Hovedstaden;2022-10-12;F;171;0;10;7235;3298705;61943
Midtjylland;2022-10-12;F;170;0;1;7235;3298875;61944
Nordjylland;2022-10-12;F;80;1;5;7236;3298955;61949
Sjælland;2022-10-12;F;128;2;10;7238;3299083;61959
Syddanmark;2022-10-12;F;179;1;9;7239;3299262;61968
Hovedstaden;2022-10-12;M;154;0;12;7239;3299416;61980
Midtjylland;2022-10-12;M;153;0;10;7239;3299569;61990
Nordjylland;2022-10-12;M;80;0;1;7239;3299649;61991
Sjælland;2022-10-12;M;116;2;10;7241;3299765;62001
Syddanmark;2022-10-12;M;167;4;16;7245;3299932;62017
Hovedstaden;2022-10-13;F;186;3;15;7248;3300118;62032
Midtjylland;2022-10-13;F;142;1;7;7249;3300260;62039
Nordjylland;2022-10-13;F;84;1;4;7250;3300344;62043
Sjælland;2022-10-13;F;133;4;9;7254;3300477;62052
Syddanmark;2022-10-13;F;164;0;10;7254;3300641;62062
Hovedstaden;2022-10-13;M;138;2;10;7256;3300779;62072
Midtjylland;2022-10-13;M;142;1;11;7257;3300921;62083
Nordjylland;2022-10-13;M;62;1;5;7258;3300983;62088
Sjælland;2022-10-13;M;107;2;9;7260;3301090;62097
Syddanmark;2022-10-13;M;129;1;7;7261;3301219;62104
Hovedstaden;2022-10-14;F;155;0;13;7261;3301374;62117
Midtjylland;2022-10-14;F;150;2;9;7263;3301524;62126
Nordjylland;2022-10-14;F;78;0;2;7263;3301602;62128
Sjælland;2022-10-14;F;125;0;10;7263;3301727;62138
Syddanmark;2022-10-14;F;153;2;9;7265;3301880;62147
Hovedstaden;2022-10-14;M;135;2;26;7267;3302015;62173
Midtjylland;2022-10-14;M;125;0;10;7267;3302140;62183
Nordjylland;2022-10-14;M;65;1;7;7268;3302205;62190
Sjælland;2022-10-14;M;119;2;14;7270;3302324;62204
Syddanmark;2022-10-14;M;134;0;10;7270;3302458;62214
Hovedstaden;2022-10-15;F;123;1;15;7271;3302581;62229
Midtjylland;2022-10-15;F;134;0;7;7271;3302715;62236
Nordjylland;2022-10-15;F;52;1;4;7272;3302767;62240
Sjælland;2022-10-15;F;82;0;6;7272;3302849;62246
Syddanmark;2022-10-15;F;77;0;6;7272;3302926;62252
Hovedstaden;2022-10-15;M;112;0;15;7272;3303038;62267
Midtjylland;2022-10-15;M;111;1;6;7273;3303149;62273
Nordjylland;2022-10-15;M;49;1;7;7274;3303198;62280
Sjælland;2022-10-15;M;90;1;15;7275;3303288;62295
Syddanmark;2022-10-15;M;72;2;11;7277;3303360;62306
Hovedstaden;2022-10-16;F;133;1;13;7278;3303493;62319
Midtjylland;2022-10-16;F;139;0;8;7278;3303632;62327
Nordjylland;2022-10-16;F;48;0;4;7278;3303680;62331
Sjælland;2022-10-16;F;83;1;9;7279;3303763;62340
Syddanmark;2022-10-16;F;148;1;9;7280;3303911;62349
Hovedstaden;2022-10-16;M;136;3;19;7283;3304047;62368
Midtjylland;2022-10-16;M;125;0;8;7283;3304172;62376
Nordjylland;2022-10-16;M;45;2;6;7285;3304217;62382
Sjælland;2022-10-16;M;85;0;10;7285;3304302;62392
Syddanmark;2022-10-16;M;116;0;6;7285;3304418;62398
Hovedstaden;2022-10-17;F;205;1;15;7286;3304623;62413
Midtjylland;2022-10-17;F;164;0;9;7286;3304787;62422
Nordjylland;2022-10-17;F;86;0;4;7286;3304873;62426
Sjælland;2022-10-17;F;139;0;9;7286;3305012;62435
Syddanmark;2022-10-17;F;187;1;9;7287;3305199;62444
Hovedstaden;2022-10-17;M;164;2;15;7289;3305363;62459
Midtjylland;2022-10-17;M;143;0;7;7289;3305506;62466
Nordjylland;2022-10-17;M;82;1;17;7290;3305588;62483
Sjælland;2022-10-17;M;128;0;13;7290;3305716;62496
Syddanmark;2022-10-17;M;163;2;10;7292;3305879;62506
Hovedstaden;2022-10-18;F;170;3;11;7295;3306049;62517
Midtjylland;2022-10-18;F;169;2;15;7297;3306218;62532
Nordjylland;2022-10-18;F;68;1;2;7298;3306286;62534
Sjælland;2022-10-18;F;125;1;14;7299;3306411;62548
Syddanmark;2022-10-18;F;196;1;8;7300;3306607;62556
Hovedstaden;2022-10-18;M;166;1;28;7301;3306773;62584
Midtjylland;2022-10-18;M;149;1;10;7302;3306922;62594
Nordjylland;2022-10-18;M;45;1;2;7303;3306967;62596
Sjælland;2022-10-18;M;130;2;9;7305;3307097;62605
Syddanmark;2022-10-18;M;171;2;17;7307;3307268;62622
Hovedstaden;2022-10-19;F;143;1;14;7308;3307411;62636
Midtjylland;2022-10-19;F;138;1;6;7309;3307549;62642
Nordjylland;2022-10-19;F;66;1;3;7310;3307615;62645
Sjælland;2022-10-19;F;128;1;7;7311;3307743;62652
Syddanmark;2022-10-19;F;143;2;11;7313;3307886;62663
Hovedstaden;2022-10-19;M;144;0;12;7313;3308030;62675
Midtjylland;2022-10-19;M;124;0;11;7313;3308154;62686
Nordjylland;2022-10-19;M;43;1;5;7314;3308197;62691
Sjælland;2022-10-19;M;132;0;14;7314;3308329;62705
Syddanmark;2022-10-19;M;132;0;9;7314;3308461;62714
Hovedstaden;2022-10-20;F;144;1;17;7315;3308605;62731
Midtjylland;2022-10-20;F;115;1;5;7316;3308720;62736
Nordjylland;2022-10-20;F;39;0;1;7316;3308759;62737
Sjælland;2022-10-20;F;95;0;9;7316;3308854;62746
Syddanmark;2022-10-20;F;121;1;10;7317;3308975;62756
Hovedstaden;2022-10-20;M;127;0;19;7317;3309102;62775
Midtjylland;2022-10-20;M;104;0;5;7317;3309206;62780
Nordjylland;2022-10-20;M;35;0;6;7317;3309241;62786
Sjælland;2022-10-20;M;79;0;11;7317;3309320;62797
Syddanmark;2022-10-20;M;111;1;10;7318;3309431;62807
Hovedstaden;2022-10-21;F;150;1;16;7319;3309581;62823
Midtjylland;2022-10-21;F;106;0;3;7319;3309687;62826
Nordjylland;2022-10-21;F;51;1;6;7320;3309738;62832
Sjælland;2022-10-21;F;81;1;4;7321;3309819;62836
Syddanmark;2022-10-21;F;127;0;5;7321;3309946;62841
Hovedstaden;2022-10-21;M;111;1;10;7322;3310057;62851
Midtjylland;2022-10-21;M;102;0;8;7322;3310159;62859
Nordjylland;2022-10-21;M;37;0;1;7322;3310196;62860
Sjælland;2022-10-21;M;78;1;10;7323;3310274;62870
Syddanmark;2022-10-21;M;106;1;14;7324;3310380;62884
Hovedstaden;2022-10-22;F;113;2;14;7326;3310493;62898
Midtjylland;2022-10-22;F;101;0;3;7326;3310594;62901
Nordjylland;2022-10-22;F;32;2;6;7328;3310626;62907
Sjælland;2022-10-22;F;67;1;5;7329;3310693;62912
Syddanmark;2022-10-22;F;74;2;8;7331;3310767;62920
Hovedstaden;2022-10-22;M;88;1;12;7332;3310855;62932
Midtjylland;2022-10-22;M;94;0;5;7332;3310949;62937
Nordjylland;2022-10-22;M;28;1;7;7333;3310977;62944
Sjælland;2022-10-22;M;58;0;4;7333;3311035;62948
Syddanmark;2022-10-22;M;56;0;6;7333;3311091;62954
Hovedstaden;2022-10-23;F;111;1;8;7334;3311202;62962
Midtjylland;2022-10-23;F;120;1;7;7335;3311322;62969
Nordjylland;2022-10-23;F;31;0;1;7335;3311353;62970
Sjælland;2022-10-23;F;89;0;9;7335;3311442;62979
Syddanmark;2022-10-23;F;147;0;4;7335;3311589;62983
Hovedstaden;2022-10-23;M;96;0;14;7335;3311685;62997
Midtjylland;2022-10-23;M;108;1;7;7336;3311793;63004
Nordjylland;2022-10-23;M;27;0;5;7336;3311820;63009
Sjælland;2022-10-23;M;69;0;7;7336;3311889;63016
Syddanmark;2022-10-23;M;117;1;9;7337;3312006;63025
Hovedstaden;2022-10-24;F;169;2;20;7339;3312175;63045
Midtjylland;2022-10-24;F;159;0;6;7339;3312334;63051
Nordjylland;2022-10-24;F;69;0;3;7339;3312403;63054
Sjælland;2022-10-24;F;109;1;8;7340;3312512;63062
Syddanmark;2022-10-24;F;162;0;8;7340;3312674;63070
Hovedstaden;2022-10-24;M;140;2;14;7342;3312814;63084
Midtjylland;2022-10-24;M;127;1;8;7343;3312941;63092
Nordjylland;2022-10-24;M;65;1;7;7344;3313006;63099
Sjælland;2022-10-24;M;98;3;10;7347;3313104;63109
Syddanmark;2022-10-24;M;142;1;8;7348;3313246;63117
Hovedstaden;2022-10-25;F;138;0;5;7348;3313384;63122
Midtjylland;2022-10-25;F;125;0;3;7348;3313509;63125
Nordjylland;2022-10-25;F;49;0;0;7348;3313558;63125
Sjælland;2022-10-25;F;114;1;9;7349;3313672;63134
Syddanmark;2022-10-25;F;151;1;10;7350;3313823;63144
Hovedstaden;2022-10-25;M;121;0;15;7350;3313944;63159
Midtjylland;2022-10-25;M;120;0;5;7350;3314064;63164
Nordjylland;2022-10-25;M;42;1;4;7351;3314106;63168
Sjælland;2022-10-25;M;93;0;7;7351;3314199;63175
Syddanmark;2022-10-25;M;139;4;10;7355;3314338;63185
Hovedstaden;2022-10-26;F;146;5;18;7360;3314484;63203
Midtjylland;2022-10-26;F;126;0;5;7360;3314610;63208
Nordjylland;2022-10-26;F;60;1;4;7361;3314670;63212
Sjælland;2022-10-26;F;112;1;5;7362;3314782;63217
Syddanmark;2022-10-26;F;125;0;6;7362;3314907;63223
Hovedstaden;2022-10-26;M;106;2;12;7364;3315013;63235
Midtjylland;2022-10-26;M;95;0;7;7364;3315108;63242
Nordjylland;2022-10-26;M;43;0;6;7364;3315151;63248
Sjælland;2022-10-26;M;118;1;8;7365;3315269;63256
Syddanmark;2022-10-26;M;104;4;11;7369;3315373;63267
Hovedstaden;2022-10-27;F;121;1;11;7370;3315494;63278
Midtjylland;2022-10-27;F;102;0;4;7370;3315596;63282
Nordjylland;2022-10-27;F;31;0;2;7370;3315627;63284
Sjælland;2022-10-27;F;92;0;5;7370;3315719;63289
Syddanmark;2022-10-27;F;102;1;6;7371;3315821;63295
Hovedstaden;2022-10-27;M;97;1;12;7372;3315918;63307
Midtjylland;2022-10-27;M;74;1;7;7373;3315992;63314
Nordjylland;2022-10-27;M;26;1;6;7374;3316018;63320
Sjælland;2022-10-27;M;70;0;10;7374;3316088;63330
Syddanmark;2022-10-27;M;85;0;5;7374;3316173;63335
Hovedstaden;2022-10-28;F;104;0;6;7374;3316277;63341
Midtjylland;2022-10-28;F;89;0;2;7374;3316366;63343
Nordjylland;2022-10-28;F;52;0;2;7374;3316418;63345
Sjælland;2022-10-28;F;71;0;6;7374;3316489;63351
Syddanmark;2022-10-28;F;69;0;3;7374;3316558;63354
Hovedstaden;2022-10-28;M;107;2;14;7376;3316665;63368
Midtjylland;2022-10-28;M;73;4;6;7380;3316738;63374
Nordjylland;2022-10-28;M;36;0;3;7380;3316774;63377
Sjælland;2022-10-28;M;51;0;5;7380;3316825;63382
Syddanmark;2022-10-28;M;79;1;8;7381;3316904;63390
Hovedstaden;2022-10-29;F;86;0;12;7381;3316990;63402
Midtjylland;2022-10-29;F;59;0;4;7381;3317049;63406
Nordjylland;2022-10-29;F;20;0;3;7381;3317069;63409
Sjælland;2022-10-29;F;56;1;4;7382;3317125;63413
Syddanmark;2022-10-29;F;44;0;5;7382;3317169;63418
Hovedstaden;2022-10-29;M;84;0;4;7382;3317253;63422
Midtjylland;2022-10-29;M;53;0;0;7382;3317306;63422
Nordjylland;2022-10-29;M;17;1;3;7383;3317323;63425
Sjælland;2022-10-29;M;47;3;3;7386;3317370;63428
Syddanmark;2022-10-29;M;38;0;7;7386;3317408;63435
Hovedstaden;2022-10-30;F;85;0;7;7386;3317493;63442
Midtjylland;2022-10-30;F;69;0;3;7386;3317562;63445
Nordjylland;2022-10-30;F;24;0;0;7386;3317586;63445
Sjælland;2022-10-30;F;56;0;2;7386;3317642;63447
Syddanmark;2022-10-30;F;67;1;2;7387;3317709;63449
Hovedstaden;2022-10-30;M;72;1;5;7388;3317781;63454
Midtjylland;2022-10-30;M;73;0;2;7388;3317854;63456
Nordjylland;2022-10-30;M;26;1;4;7389;3317880;63460
Sjælland;2022-10-30;M;56;0;6;7389;3317936;63466
Syddanmark;2022-10-30;M;55;0;5;7389;3317991;63471
Hovedstaden;2022-10-31;F;115;0;10;7389;3318106;63481
Midtjylland;2022-10-31;F;91;1;6;7390;3318197;63487
Nordjylland;2022-10-31;F;50;0;5;7390;3318247;63492
Sjælland;2022-10-31;F;81;0;5;7390;3318328;63497
Syddanmark;2022-10-31;F;97;0;7;7390;3318425;63504
Hovedstaden;2022-10-31;M;103;1;11;7391;3318528;63515
Midtjylland;2022-10-31;M;90;0;9;7391;3318618;63524
Nordjylland;2022-10-31;M;43;1;5;7392;3318661;63529
Sjælland;2022-10-31;M;72;0;4;7392;3318733;63533
Syddanmark;2022-10-31;M;95;2;6;7394;3318828;63539
Hovedstaden;2022-11-01;F;111;0;5;7394;3318939;63544
Midtjylland;2022-11-01;F;82;0;3;7394;3319021;63547
Nordjylland;2022-11-01;F;19;0;1;7394;3319040;63548
Sjælland;2022-11-01;F;70;0;5;7394;3319110;63553
Syddanmark;2022-11-01;F;79;1;4;7395;3319189;63557
Hovedstaden;2022-11-01;M;81;0;10;7395;3319270;63567
Midtjylland;2022-11-01;M;88;1;6;7396;3319358;63573
Nordjylland;2022-11-01;M;33;1;6;7397;3319391;63579
Sjælland;2022-11-01;M;46;0;7;7397;3319437;63586
Syddanmark;2022-11-01;M;77;0;5;7397;3319514;63591
Hovedstaden;2022-11-02;F;94;1;9;7398;3319608;63600
Midtjylland;2022-11-02;F;80;0;1;7398;3319688;63601
Nordjylland;2022-11-02;F;45;0;5;7398;3319733;63606
Sjælland;2022-11-02;F;65;0;3;7398;3319798;63609
Syddanmark;2022-11-02;F;80;0;6;7398;3319878;63615
Hovedstaden;2022-11-02;M;68;1;10;7399;3319946;63625
Midtjylland;2022-11-02;M;71;0;3;7399;3320017;63628
Nordjylland;2022-11-02;M;26;0;2;7399;3320043;63630
Sjælland;2022-11-02;M;58;0;4;7399;3320101;63634
Syddanmark;2022-11-02;M;80;0;5;7399;3320181;63639
Hovedstaden;2022-11-03;F;104;0;9;7399;3320285;63648
Midtjylland;2022-11-03;F;75;0;7;7399;3320360;63655
Nordjylland;2022-11-03;F;26;0;2;7399;3320386;63657
Sjælland;2022-11-03;F;63;0;7;7399;3320449;63664
Syddanmark;2022-11-03;F;62;0;6;7399;3320511;63670
Hovedstaden;2022-11-03;M;88;0;5;7399;3320599;63675
Midtjylland;2022-11-03;M;64;0;4;7399;3320663;63679
Nordjylland;2022-11-03;M;26;0;1;7399;3320689;63680
Sjælland;2022-11-03;M;48;0;2;7399;3320737;63682
Syddanmark;2022-11-03;M;49;0;2;7399;3320786;63684
Hovedstaden;2022-11-04;F;79;0;6;7399;3320865;63690
Midtjylland;2022-11-04;F;75;0;4;7399;3320940;63694
Nordjylland;2022-11-04;F;19;0;1;7399;3320959;63695
Sjælland;2022-11-04;F;49;0;5;7399;3321008;63700
Syddanmark;2022-11-04;F;51;0;3;7399;3321059;63703
Hovedstaden;2022-11-04;M;69;0;5;7399;3321128;63708
Midtjylland;2022-11-04;M;62;0;2;7399;3321190;63710
Nordjylland;2022-11-04;M;29;1;1;7400;3321219;63711
Sjælland;2022-11-04;M;57;0;8;7400;3321276;63719
Syddanmark;2022-11-04;M;58;0;3;7400;3321334;63722
Hovedstaden;2022-11-05;F;63;0;4;7400;3321397;63726
Midtjylland;2022-11-05;F;42;1;2;7401;3321439;63728
Nordjylland;2022-11-05;F;10;0;0;7401;3321449;63728
Sjælland;2022-11-05;F;42;0;5;7401;3321491;63733
Syddanmark;2022-11-05;F;42;1;6;7402;3321533;63739
Hovedstaden;2022-11-05;M;40;0;6;7402;3321573;63745
Midtjylland;2022-11-05;M;44;0;2;7402;3321617;63747
Nordjylland;2022-11-05;M;8;0;2;7402;3321625;63749
Sjælland;2022-11-05;M;32;0;2;7402;3321657;63751
Syddanmark;2022-11-05;M;29;1;5;7403;3321686;63756
Hovedstaden;2022-11-06;F;66;1;5;7404;3321752;63761
Midtjylland;2022-11-06;F;62;0;1;7404;3321814;63762
Nordjylland;2022-11-06;F;18;0;1;7404;3321832;63763
Sjælland;2022-11-06;F;44;0;7;7404;3321876;63770
Syddanmark;2022-11-06;F;59;0;2;7404;3321935;63772
Hovedstaden;2022-11-06;M;64;0;4;7404;3321999;63776
Midtjylland;2022-11-06;M;51;0;2;7404;3322050;63778
Nordjylland;2022-11-06;M;19;0;5;7404;3322069;63783
Sjælland;2022-11-06;M;49;0;5;7404;3322118;63788
Syddanmark;2022-11-06;M;51;0;3;7404;3322169;63791
Hovedstaden;2022-11-07;F;122;0;10;7404;3322291;63801
Midtjylland;2022-11-07;F;91;0;4;7404;3322382;63805
Nordjylland;2022-11-07;F;40;0;5;7404;3322422;63810
Sjælland;2022-11-07;F;65;0;5;7404;3322487;63815
Syddanmark;2022-11-07;F;86;0;6;7404;3322573;63821
Hovedstaden;2022-11-07;M;93;0;8;7404;3322666;63829
Midtjylland;2022-11-07;M;68;0;2;7404;3322734;63831
Nordjylland;2022-11-07;M;32;0;1;7404;3322766;63832
Sjælland;2022-11-07;M;65;0;5;7404;3322831;63837
Syddanmark;2022-11-07;M;58;0;2;7404;3322889;63839
Hovedstaden;2022-11-08;F;129;1;7;7405;3323018;63846
Midtjylland;2022-11-08;F;70;0;2;7405;3323088;63848
Nordjylland;2022-11-08;F;28;0;1;7405;3323116;63849
Sjælland;2022-11-08;F;77;0;3;7405;3323193;63852
Syddanmark;2022-11-08;F;95;0;7;7405;3323288;63859
Hovedstaden;2022-11-08;M;96;0;8;7405;3323384;63867
Midtjylland;2022-11-08;M;61;0;7;7405;3323445;63874
Nordjylland;2022-11-08;M;18;0;2;7405;3323463;63876
Sjælland;2022-11-08;M;62;0;7;7405;3323525;63883
Syddanmark;2022-11-08;M;84;0;6;7405;3323609;63889
Hovedstaden;2022-11-09;F;109;0;5;7405;3323718;63894
Midtjylland;2022-11-09;F;87;0;2;7405;3323805;63896
Nordjylland;2022-11-09;F;40;0;2;7405;3323845;63898
Sjælland;2022-11-09;F;97;0;5;7405;3323942;63903
Syddanmark;2022-11-09;F;81;0;5;7405;3324023;63908
Hovedstaden;2022-11-09;M;99;0;7;7405;3324122;63915
Midtjylland;2022-11-09;M;79;0;2;7405;3324201;63917
Nordjylland;2022-11-09;M;35;0;1;7405;3324236;63918
Sjælland;2022-11-09;M;72;0;0;7405;3324308;63918
Syddanmark;2022-11-09;M;72;0;1;7405;3324380;63919
Hovedstaden;2022-11-10;F;103;0;7;7405;3324483;63926
Midtjylland;2022-11-10;F;85;0;2;7405;3324568;63928
Nordjylland;2022-11-10;F;34;0;0;7405;3324602;63928
Sjælland;2022-11-10;F;61;0;3;7405;3324663;63931
Syddanmark;2022-11-10;F;66;0;3;7405;3324729;63934
Hovedstaden;2022-11-10;M;84;0;9;7405;3324813;63943
Midtjylland;2022-11-10;M;54;0;3;7405;3324867;63946
Nordjylland;2022-11-10;M;25;1;3;7406;3324892;63949
Sjælland;2022-11-10;M;43;0;2;7406;3324935;63951
Syddanmark;2022-11-10;M;54;0;5;7406;3324989;63956
Hovedstaden;2022-11-11;F;89;0;6;7406;3325078;63962
Midtjylland;2022-11-11;F;56;0;4;7406;3325134;63966
Nordjylland;2022-11-11;F;35;0;1;7406;3325169;63967
Sjælland;2022-11-11;F;51;0;4;7406;3325220;63971
Syddanmark;2022-11-11;F;58;0;2;7406;3325278;63973
Hovedstaden;2022-11-11;M;77;0;8;7406;3325355;63981
Midtjylland;2022-11-11;M;34;0;1;7406;3325389;63982
Nordjylland;2022-11-11;M;25;1;1;7407;3325414;63983
Sjælland;2022-11-11;M;48;0;5;7407;3325462;63988
Syddanmark;2022-11-11;M;37;0;2;7407;3325499;63990
Hovedstaden;2022-11-12;F;69;0;5;7407;3325568;63995
Midtjylland;2022-11-12;F;40;0;0;7407;3325608;63995
Nordjylland;2022-11-12;F;19;0;2;7407;3325627;63997
Sjælland;2022-11-12;F;47;0;3;7407;3325674;64000
Syddanmark;2022-11-12;F;34;0;0;7407;3325708;64000
Hovedstaden;2022-11-12;M;65;0;4;7407;3325773;64004
Midtjylland;2022-11-12;M;39;0;2;7407;3325812;64006
Nordjylland;2022-11-12;M;12;0;1;7407;3325824;64007
Sjælland;2022-11-12;M;44;0;4;7407;3325868;64011
Syddanmark;2022-11-12;M;37;0;2;7407;3325905;64013
Hovedstaden;2022-11-13;F;84;0;4;7407;3325989;64017
Midtjylland;2022-11-13;F;43;0;2;7407;3326032;64019
Nordjylland;2022-11-13;F;20;0;2;7407;3326052;64021
Sjælland;2022-11-13;F;45;0;3;7407;3326097;64024
Syddanmark;2022-11-13;F;71;0;1;7407;3326168;64025
Hovedstaden;2022-11-13;M;53;0;2;7407;3326221;64027
Midtjylland;2022-11-13;M;48;0;1;7407;3326269;64028
Nordjylland;2022-11-13;M;18;0;1;7407;3326287;64029
Sjælland;2022-11-13;M;48;0;6;7407;3326335;64035
Syddanmark;2022-11-13;M;37;0;2;7407;3326372;64037
Hovedstaden;2022-11-14;F;1;0;1;7407;3326373;64038
